být	be
a se	and
v	in
na	on
ten	the
on	he
že	that
s	with
z	from
který	which
mít	have
do	to
já	I
o	about
k	to
i	and
jeho	his
ale	but
svůj	his
jako	as
za	for
moci	be able to
rok	year
pro	for
tak	so
po	after
tento	this
co	what
když	when
všechen	every
už	already
jak	how
aby	to
od	from
nebo	or
říci	say
jeden	one
jen	only
můj	my
jenž	that
člověk	man
ty	you
stát	state
u	at
muset	have to
velký	great
chtít	want
také	also
až	until
než	than
ještě	yet
při	at
jít	go
pak	then
před	before
dva	two
však	however
ani	neither
vědět	know
nový	new
hodně	lot
podle	by
další	next
celý	round
jiný	other
první	first
mezi	between
dát	give
tady	here
den	day
tam	there
kde	where
doba	time
každý	everyone
druhý	other
místo	place
dobrý	good
takový	such
strana	page
protože	because
nic	nothing
začít	begin
něco	something
život	life
vidět	see
říkat	say
země	country
dítě	baby
malý	little
ne	No
sám	himself
bez	without
ruka	hand
či	whether
svět	world
dostat	get
práce	work
nějaký	some
proto	therefore
pod	below
tři	three
kdy	when
město	city
přijít	come
dobře	good
žena	woman
muž	man
teď	now
kdo	who
již	already
nad	above
asi	about
starý	old
například	for example
případ	case
vysoký	high
žádný	none
společnost	company
několik	several
některý	some
tedy	therefore
cesta	journey
pokud	if
dělat	do
hlava	head
čas	time
poslední	latest
oko	eye
právě	just
tvůj	yours
Praha	Prague
věc	thing
voda	water
český	Czech
proti	against
velmi	very
jaký	what
přes	through
dům	home
dnes	today
pan	Mr.
část	section
třeba	perhaps
kdyby	if
brzy	soon
lze	You can
firma	business
oba	both
slovo	word
tenhle	this
vlastní	own
nikdy	never
koruna	crown
možný	possible
chvíle	while
udělat	do
pouze	only
proč	why
systém	system
konec	end
kolem	around
málo	little
myslit	think
stejně	anyway
-li	if
Český	Czech
moc	power
problém	issue
milión	million
nikdo	nobody
stále	still
totiž	namely
někdo	someone
tisíc	thousand
vůbec	ever
zákon	law
nechat	leave
najít	find
což	which
cena	price
rád	happy
škola	school
hlavní	main
skupina	group
mladý	young
způsob	way
často	often
řada	advice
jediný	single
mluvit	speak
vrátit	return
různý	different
hrát	play
snad	maybe
zůstat	stay
vzít	take
dlouhý	long
čekat	wait
patřit	belong
oblast	area
vláda	government
dokonce	even
známý	known
dokázat	prove
peníze	money
mnoho	many
otázka	question
vést	lead
právo	right
spíše	rather
pozdě	late
žít	live
zase	again
především	especially
ovšem	of course
takže	so
století	century
přece	yet
možnost	possibility
ostatní	other
číslo	number
jenom	only
dále	further
uvést	state
znovu	again
možná	maybe
služba	service
jestli	whether
situace	situation
stejný	the same
hodiny	hours
měsíc	Moon
získat	gain
čtyři	four
jméno	name
dveře	doors
daleko	far
otec	father
znát	know
změna	change
evropský	European
většina	most
nakonec	eventually
nyní	now
noc	night
snažit se	try
síla	power
zde	here
dojít	come
potom	then
znamenat	mean
vypadat	look
pět	five
informace	information
americký	American
trochu	a little
týden	week
důležitý	important
příliš	too
vztah	relationship
trh	market
tělo	body
válka	war
hned	immediately
slyšet	hear
téměř	almost
dlouho	long
rodina	family
zatím	yet
rozhodnout	choose
výsledek	outcome
ano	yes
pracovat	work
státní	state
pohled	view
zájem	interest
zeptat se	ask
ulice	street
potřebovat	need
tvář	face
zdát se	seem
kniha	book
důvod	reason
hlas	voice
film	movie
pravda	truth
někdy	sometimes
objevit	discover
dost	enough
základní	basic
zcela	completely
přitom	yet
paní	Ms
smrt	death
matka	mother
sice	Although
rychle	quickly
cítit	feel
minuta	minute
pár	couple
procento	percentage
program	program
určitý	some
večer	evening
během	during
existovat	exist
kvůli	about
hodnota	value
bílý	white
noha	foot
jistý	some
jednou	once
podívat se	look
včera	yesterday
plný	full
člen	member
vlastně	actually
lidský	human
sedět	sit
podmínka	condition
vždy	always
navíc	moreover
osoba	person
hra	game
počet	count
tehdy	then
republika	republic
přímo	right
stav	status
banka	bank
politický	political
hodina	lesson
obraz	image
zejména	especially
ať	whatever
činnost	activity
podnik	enterprise
jinak	otherwise
druh	kind
soud	court
opět	again
národní	national
úřad	office
podobný	similar
deset	ten
kromě	except
nejen	not only
auto	car
ukázat	show
černý	black
zda	whether
platit	pay
špatný	bad
otevřít	open
vždycky	always
dávat	give
cíl	target
psát	write
chodit	walk
jednotlivý	single
sociální	social
považovat	consider
současný	contemporary
Evropa	Europe
neboť	because
Jan	John
zpráva	report
typ	type
policie	police
stačit	suffice
opravdu	really
skutečnost	reality
věřit	believe
pocit	feeling
dílo	work
silný	thick
sto	hundred
spolu	together
německý	German
vedle	next to
tvrdit	claim
základ	foundation
pořád	always
bůh	god
prostředí	environment
samozřejmě	of course
jet	go
zřejmě	apparently
zjistit	find out
světlo	light
smysl	sense
směr	direction
růst	growth
ředitel	director
ráno	morning
zatímco	while
myslet	think
láska	love
divadlo	theater
proces	trial
podařit se	do well
forma	form
stůl	table
prý	allegedly
pokračovat	continue
sem	here
názor	opinion
těžký	heavy
okno	window
pomoci	help
světový	worldwide
napsat	write
smlouva	agreement
veřejný	public
skončit	end
začínat	begin
rada	advice
ležet	lie
přítel	boyfriend
kraj	county
úplně	completely
třetí	third
odpovědět	answer
změnit	change
dodat	supply
krásný	beautiful
byt	apartment
nutný	necessary
jednat	deal
pracovní	working
hledat	search
vývoj	development
prezident	president
role	role
představovat	represent
pokoj	room
období	season
nízký	low
přesto	yet
vyjít	come out
bývalý	former
polovina	half
projekt	project
dívat se	watch
připravit	prepare
takzvaný	so-called
potřeba	need
používat	use
držet	hold
ministr	minister
vůz	car
zároveň	together
dosud	yet
doktor	doctor
funkce	function
naopak	conversely
volba	option
zvláštní	strange
jasný	clear
syn	son
teprve	only
obec	village
akce	action
zdroj	source
pražský	Prague
úroveň	level
rozdíl	difference
významný	significant
trvat	last
hlavně	mainly
prostor	space
šest	six
řízení	management
stavba	building
životní	life
klub	club
miliarda	billion
pomoc	help
prostě	just
organizace	organization
vydat	issue
bývat	dwell
tým	team
díky	thanks
skutečně	really
no	well
centrum	center
začátek	beginning
přesně	exactly
srdce	heart
krok	move
dosáhnout	reach
prostředek	means
postavit	stand
obchodní	business
působit	act
materiál	material
odejít	leave
společný	common
tolik	so much
autor	author
domácí	home
náklad	load
návrh	proposal
kam	where
finanční	financial
řešení	solution
brát	take
vliv	effect
Petr	Peter
míra	degree
zařízení	equipment
jistě	surely
konečně	finally
onen	that
výroba	production
mezinárodní	international
zastavit	stop
lékař	doctor
vhodný	suitable
jednání	negotiation
smět	may
politika	politics
půl	half
schopný	able
obchod	business
kolo	bike
rovněž	also
zápas	match
umění	art
hranice	border
loď	ship
umět	know
vytvořit	create
doma	home
určitě	definitely
ministerstvo	ministry
poté	after
postup	approach
velice	very
místní	local
zkušenost	experience
rodič	parent
bod	point
pán	lord
tvořit	generate
osobní	personal
dívka	girl
ČR	Czech Republic
jakýsi	sort of
výkon	performance
mimo	outside
svatý	saint
Jiří	Jiri
rámec	framework
okamžik	moment
vedení	leadership
pohyb	motion
obyvatel	inhabitant
duch	spirit
jazyk	tongue
minulý	last
myšlenka	thought
zaměstnanec	employee
představit	present
poprvé	first
hudba	music
vzniknout	develop
sledovat	watch
rozhodnutí	decision
věnovat	pay
skoro	almost
mnohem	much
příští	next
dopis	letter
přinést	bring
nemocnice	hospital
řeka	river
zákazník	customer
pravý	right
střední	middle
množství	quantity
poznat	learn
alespoň	at least
prohlásit	declare
raději	rather
včetně	including
plán	plan
síť	network
spojený	connected
obrázek	picture
strom	tree
podoba	shape
najednou	suddenly
barva	color
široký	wide
stránka	page
krátký	short
Kč	CZK
mnohý	many
budova	building
nabízet	bid
vlas	hair
list	sheet
městský	urban
součást	component
USA	USA
celkový	overall
víno	wine
televize	TV
věk	age
použít	apply
úspěch	success
význam	importance
podpora	promotion
šéf	boss
moderní	modern
příklad	example
článek	article
představa	idea
číst	read
ztratit	lose
unie	union
přijmout	accept
letos	this year
úkol	task
slunce	sun
zapomenout	forget
většinou	mostly
blízký	close
pes	dog
chápat	understand
metr	meter
les	forest
hora	mountain
bratr	brother
de	de
prosit	plead
vzduch	air
text	text
přidat	add
přijet	arrive
jenže	only
dolar	dollar
schopnost	ability
soutěž	competition
voják	soldier
strach	fear
hráč	player
avšak	yet
mrtvý	dead
Německo	Germany
skutečný	real
dcera	daughter
zajímavý	interesting
výstava	exhibition
francouzský	French
jakýkoliv	whatever
energie	power
zahraniční	foreign
policista	policeman
dvacet	twenty
mluvčí	spokesman
docela	quite
počátek	beginning
boj	fight
připadat	seem
poslat	send
doprava	right
vnitřní	internal
papír	paper
koupit	buy
uvidět	see
občan	citizen
Pavel	Paul
Brno	Brno
rameno	shoulder
předseda	chairman
zvíře	beast
odpovídat	answer
bát se	fear
napadnout	attack
požadavek	demand
metoda	method
moře	sea
domů	home
ochrana	protection
odpověď	answer
přístup	access
zemřít	die
manžel	husband
král	king
třída	class
sen	dream
ptát se	ask
prst	finger
vysvětlit	explain
jednotka	unit
technický	technological
kultura	culture
pole	field
zůstávat	stay
Karel	Karel
právní	legal
správný	right
červený	red
krev	blood
zhruba	roughly
jmenovat	appoint
počítat	count
chlapec	boy
silnice	highway
stavební	structural
pracovník	worker
obvykle	usually
kolik	how many
líbit se	like
hvězda	star
bezpečný	safe
rozumět	understand
původní	original
obličej	face
provoz	traffic
látka	substance
volný	free
rozvoj	development
radost	pleasure
předmět	subject
sedm	seven
britský	British
vedoucí	leader
šťastný	happy
území	area
útok	attack
jednoduchý	single
chování	behavior
přestat	stop
příběh	story
jestliže	if
ekonomický	economic
událost	event
podobně	similarly
Josef	Josef
pomalu	slowly
řeč	speech
název	title
obrovský	huge
téma	theme
spát	sleep
stroj	machine
milovat	love
pochopit	understand
postava	character
průběh	course
zelený	green
dnešní	contemporary
vycházet	come out
měnit	change
vojenský	military
závěr	conclusion
postel	bed
využít	exploit
zrovna	right
prodej	sale
svoboda	freedom
běžný	common
stěna	wall
vždyť	after all
aspoň	at least
výše	above
zástupce	deputy
telefon	phone
vybrat	choose
pozornost	attention
osm	eight
zajímat	interest
přát	wish
model	model
místnost	room
objekt	building
čistý	clear
nabídka	bid
m	m
ukazovat	show
přesvědčit	convince
spousta	lot
majitel	owner
důsledek	consequence
nikoliv	not
muzeum	museum
zahrada	garden
rychlý	fast
okolí	surroundings
občas	occasionally
kůň	horse
vloni	last year
otevřený	open
postupně	gradually
zmizet	disappear
ostrov	island
živý	alive
armáda	army
sloužit	serve
příležitost	opportunity
následující	next
kvalita	quality
orgán	organ
ruský	Russian
zaplatit	pay
kus	piece
EU	EU
očekávat	expect
souvislost	relationship
pustit	let go
komise	commission
přicházet	come
vracet	return
fond	fund
správa	management
jídlo	food
výrobek	product
příprava	preparation
l	l
samý	very
hovořit	talk
ztráta	loss
předtím	before that
zpátky	back
samotný	very
fotografie	photos
povinnost	duty
příjemný	nice
provést	perform
obrátit	turn
úspěšný	successful
vůči	towards
duše	soul
letošní	this year
kancelář	office
g	g
historie	history
buď	either
Václav	Václav
stávat	becoming
čelo	forehead
hledisko	viewpoint
škoda	damage
maso	meat
slavný	famous
kontrola	check
zboží	goods
hluboký	deep
přímý	straight
uvedený	given
kousek	piece
nést	carry
struktura	structure
zlatý	gold
zeď	wall
obsahovat	contain
řidič	driver
příroda	nature
někde	somewhere
takhle	this
stanice	station
veškerý	all
sestra	sister
ústa	mouth
uvědomit	remember
pravidlo	rule
technika	technology
historický	historical
proud	current
kdysi	once
stupeň	degree
vstup	input
znít	sound
majetek	possession
závod	plant
podíl	share
návštěva	visit
podstata	nature
potvrdit	confirm
spolupráce	cooperation
předpokládat	assume
týkat se	relate to
snaha	effort
manželka	wife
způsobit	cause
maminka	mom
dokud	until
pokus	trial
doufat	hope
vzhledem	due
daný	given
zbytek	rest
datum	date
daň	tax
kostel	church
položit	lay
září	September
šance	chance
host	guest
technologie	technology
dovolit	allow
kulturní	cultural
opatření	measures
blízko	close
nástroj	tool
půda	soil
vytvářet	generate
okamžitě	immediately
vyhrát	win
příčina	cause
trenér	trainer
pouhý	mere
projít	go through
využívat	exploit
soukromý	private
žák	pupil
podat	submit
b	b
umožňovat	allow
dít	happen
zajistit	secure
všimnout	notice
si	to
rozhovor	interview
záda	back
docházet	resort
náměstí	plaza
minulost	past
vysoko	high
veřejnost	public
scéna	scene
dovést	lead
uvádět	featuring
štěstí	happiness
pokusit se	try
hotel	hotel
konečný	final
odmítnout	refuse
rozhodně	definitely
vstoupit	enter
zbraň	weapon
ačkoliv	although
bohatý	wealthy
rychlost	speed
most	bridge
společenský	social
založit	establish
aktivita	activity
opustit	leave
přestože	even though
student	student
vzpomínat	reminisce
prvek	element
pohybovat	move
riziko	risk
záležitost	affair
chovat	rear
dostávat	receive
nějak	somehow
mistr	champion
jezdit	ride
hodit	throw
divák	spectator
neděle	Sunday
obsah	contents
cizí	foreign
výraz	expression
vrstva	layer
konkrétní	specific
připomínat	remind
pomáhat	help
dopravní	transport
údaj	reading
řád	order
počítač	computer
pořádek	tidiness
Francie	France
špatně	poorly
plocha	area
hospodářský	economic
ODS	ODS
naděje	hopes
tvar	shape
příjem	income
západní	western
tlak	pressure
osud	fate
naprosto	totally
zabít	kill
kámen	stone
paragraf	section
policejní	police
kluk	boy
chyba	bug
bydlet	stay
učit	teach
dolů	down
modrý	blue
současně	together
souhlasit	agree
určit	identify
tentokrát	this time
celkem	total
péče	care
řídit	manage
vysvětlovat	explain
zabývat se	deal with
leden	January
fakt	fact
pozorovat	watch
oběť	victim
projev	token
volat	call
sobota	Saturday
operace	operation
snadno	easily
nabídnout	offer
amerika	america
vítr	wind
bránit	defend
viz	see
profesor	professor
národ	nation
zvýšit	increase
veliký	great
desítka	ten
olej	oil
naučit	learn
takto	thus
čin	act
aniž	without
vyprávět	recount
zima	winter
tradiční	traditional
úprava	treatment
uvažovat	consider
dohoda	agreement
požádat	ask
new	new
odborník	expert
poměr	ratio
zavolat	call
bolest	ache
odpoledne	afternoon
pomocí	through
c	C
dojem	impression
princip	principle
klient	client
pojem	notion
závislý	addicted
přiznat	grant
soubor	file
činit	do
kůže	skin
vznik	formation
příslušný	appropriate
pamatovat	remember
dávno	a long time ago
pacient	patient
výrobce	manufacturer
klid	serenity
spojení	link
učitel	teacher
společně	together
tvorba	creation
Martin	Martin
rostlina	plant
partner	partner
ohled	respect
povídat	chat
uzavřít	close down
teorie	theory
drobný	minor
provádět	perform
hudební	music
slovenský	Slovak
karta	card
rána	blow
ven	out
zahraničí	abroad
časopis	magazine
otočit	turn over
styl	style
vznikat	rise
léto	summer
výzkum	research
opakovat	repeat
komunikace	communications
nacházet	finding
všude	everywhere
tj.	i.e.
praxe	practice
vlastnost	property
dětský	children
zas	again
severní	north
osobnost	personality
poslouchat	listen
univerzita	university
odborný	expert
hrozit	threaten
pozice	position
jižní	southern
speciální	special
obor	discipline
budoucnost	future
vážně	seriously
kilometr	kilometer
reakce	reaction
chybět	be missing
chuť	flavor
vlak	train
kapitola	section
ozvat se	speak up
produkt	product
koncert	concert
poměrně	relatively
politik	politician
oznámit	announce
náhle	suddenly
ekonomika	economy
stovka	hundred
řešit	deal with
značka	brand
povrch	surface
uprostřed	middle
postavení	status
agentura	agency
vlna	wave
nýbrž	but
výrazně	distinctly
teplota	temperature
park	park
zámek	Castle
vytáhnout	pull out
těšit	forward
krk	throat
šat	raiment
prostřednictví	mediation
poslanec	deputy
vyžadovat	require
umělecký	artistic
vědomí	consciousness
slečna	lady
značný	sizable
chystat	prepare
Němec	German
následovat	follow
květen	May
červen	June
vážný	serious
zvuk	sound
jasně	clear
jakmile	once
zvláště	especially
loňský	last year
úsměv	smile
televizní	TV
tma	darkness
drahý	expensive
letadlo	aircraft
nosit	wear
potřebný	required
jo	Yeah
zpívat	sing
velikost	size
norma	standard
setkat	meet
kolega	colleague
internet	Internet
rozpočet	budget
ucho	ear
spojit	join
výrazný	significant
připravovat	cook
konstrukce	structure
zisk	profit
poněkud	somewhat
rodinný	family
stanovit	fix
též	too
poskytovat	provide
starost	concern
Čechy	Bohemia
studie	study
tvrdý	tough
fungovat	work
průmysl	industry
médium	medium
dějiny	history
domnívat se	I think that
milý	dear
dokument	document
žádat	ask
zavřít	close
oheň	fire
stín	shadow
třicet	thirty
úvaha	reasoning
břeh	bank
vzpomenout	remember
konat	hold
mysl	mind
nemoc	disease
usmát se	smile
denně	daily
končit	ending
instituce	institution
věda	science
sdělit	communicate
Paříž	Paris
uvnitř	inside
nedostatek	shortage
říjen	October
J	J
prázdný	empty
probíhat	take place
pokoušet	tempt
nicméně	however
přítomnost	presence
sotva	barely
krátce	short
návrat	return
lehký	light
píseň	song
pevný	firm
Rusko	Russia
nijak	no
kuchyně	cooking
oddělení	department
nejprve	first
víra	faith
přejít	traverse
okraj	edge
částka	sum
záležet	matter
buňka	cell
církev	church
odpad	waste
le	le
pryč	gone
apod.	like.
poskytnout	grant
výběr	selection
vítězství	victory
radnice	town hall
tradice	tradition
studio	studio
účast	participation
výhoda	benefit
zkouška	exam
noční	night
tábor	camp
běžet	run
předpis	prescription
výjimka	exception
krajina	scenery
návštěvník	visitor
nebe	heaven
herec	actor
svaz	union
klasický	classical
František	Pastille
akcie	share
postoj	attitude
střecha	top
učinit	do
účel	purpose
dodávat	deliver
vyjádřit	express
neustále	constantly
listopad	November
zdravý	healthy
použití	application
celek	complex
zvednout	pick up
dráha	track
snímek	image
Vladimír	Vladimír
napětí	tension
informovat	inform
potíž	difficulty
deska	board
bezpečnost	safety
březen	March
domov	home
srpen	August
existence	existence
starosta	mayor
dozvědět se	Learn
prodat	sell
padnout	fall
předchozí	previous
týž	the same
York	York
sníh	snow
tabulka	table
liga	league
adresa	address
duben	April
zdravotní	health
padesát	fifty
obvyklý	usual
dvakrát	twice
smát se	laugh
spatřit	see
generace	generation
investice	investment
dispozice	disposition
obrana	defense
zub	tooth
zpět	back
pivo	beer
charakter	character
poznamenat	note
ústav	institute
přemýšlet	think
nebezpečí	danger
slabý	weak
přirozený	natural
sůl	salt
objevovat	discover
délka	length
hezký	handsome
normální	normal
nemocný	sick
analýza	analysis
přední	front
galerie	gallery
zdraví	health
zásada	principle
umožnit	enable
podávat	feed
vejít	enter
výbor	committee
jaro	spring
Marie	Marie
informační	Information
kamarád	pal
the	the
dvůr	yard
umělec	artist
ostatně	moreover
filmový	movie
pravděpodobně	probably
případně	eventually
poznámka	remark
utkání	match
složitý	complex
pěkný	pretty
počkat	wait
motor	engine
vesnice	village
trest	punishment
nedávno	recently
atd	etc.
narodit	born
zvolit	choose
ryba	fish
kategorie	category
vůle	will
bohužel	unfortunately
omezený	limited
bavit	entertain
spor	dispute
těžko	difficult
Tomáš	Thomas
kino	theater
kurs	course
pocházet	come
československý	Czechoslovak
pravit	to edit the
využití	utilization
úzký	close
hladina	level
reagovat	react
Čech	Čech
vystoupit	alight
okolnost	circumstance
věta	sentence
důkaz	evidence
Jaroslav	Jaroslav
prakticky	practically
zítra	tomorrow
devět	nine
přesný	accurate
pták	bird
navštívit	visit
literatura	literature
obecný	general
výška	height
udržet	keep
vládní	governmental
ticho	silence
průmyslový	industrial
dopadnout	strike
stopa	footprint
zahájit	launch
euro	euro
vstát	rise
hledět	look
pátek	Friday
budoucí	future
Američan	American
vodní	water
bojovat	fight
II	II
klidně	quietly
obava	fear
východ	East
setkání	meeting
snížit	reduce
hrad	castle
účastník	participant
tentýž	same
ženský	female
sejít	meet
předpoklad	assumption
kapsa	pocket
manažer	manager
režim	mode
vadit	hinder
připomenout	remind
zlý	evil
vazba	weave
východní	east
výstavba	construction
představitel	representative
vnější	outer
seznam	list
elektrický	electrical
zbavit	relieve
hnutí	movement
únor	February
italský	Italian
znalost	knowledge
přinášet	produce
ret	lip
paměť	memory
jíst	eat
odjet	leave
bezpečnostní	security
nárok	claim
západ	West
prodávat	sell
vydržet	withstand
prosinec	December
podporovat	promote
nastat	come
díl	part
podlaha	flooring
dospělý	adult
původně	originally
občanský	civil
novinář	journalist
cosi	something
boží	divine
km	km
zvlášť	separately
ročník	year
vozidlo	vehicle
všecek	all the keen
krajský	regional
pozdní	late
zvýšení	increase
pít	drink
akciový	joint-stock
vražda	murder
chodba	corridor
cenný	valuable
podnikatel	businessman
Ostrava	Ostrava
odpor	resistance
přírodní	natural
touha	desire
vzájemný	mutual
podstatný	substantial
kontakt	contact
plzeň	plzeň
čtvrtý	fourth
dřevěný	wooden
mladík	youngster
chvilka	bit
průměr	average
vyrazit	set off
nos	nose
investor	investor
odmítat	reject
rozsah	scope
automobil	car
tajný	secret
vyvolat	cause
úředník	official
vzpomínka	memory
červenec	July
fáze	phase
teplý	warm
účet	bill
tušit	suspect
snadný	easy
klást	put
nápad	idea
noviny	newspaper
pondělí	Monday
účinek	effect
tiše	quietly
žádost	application
festival	festival
zkusit	try
premiér	premier
mozek	brain
zadní	rear
nahoru	up
restaurace	restaurant
anglický	English
smích	laughter
režisér	director
typický	typical
chlap	guy
plyn	gas
zbývat	remain
oblíbený	favorite
produkce	production
patnáct	fifteen
podílet	share
závislost	addiction
skvělý	great
vězení	prison
ČSSD	CSSD
sbírka	collection
finance	finance
parlament	parliament
stálý	stable
Sb	Sb
Anna	Anna
čtenář	reader
hotový	ready
termín	deadline
jízda	ride
projevit	exhibit
nepřítel	enemy
teplo	heat
Londýn	London
jemný	fine
rozsáhlý	extensive
autobus	bus
krása	beauty
cukr	sugar
promluvit	speak
kvalitní	quality
zachovat	preserve
region	region
bota	shoe
dodnes	to this day
gól	goal
zmíněný	said
hodlat	intend
svobodný	free
navrhnout	suggest
dovnitř	inwards
John	John
vnímat	perceive
spočívat	rest
přičemž	while
kruh	circle
levý	left
přibližně	about
úvěr	credit
mm	mm
označit	mark
potkat	meet
sportovní	sports
posadit	sit
faktor	factor
studovat	study
náročný	challenging
objem	volume
horký	hot
znak	character
David	David
tatínek	Daddy
nově	new
soudce	judge
překvapit	surprise
nastoupit	board
bok	hip
generální	general
dřevo	wood
jistota	certainty
soudní	court
japonský	Japanese
George	George
déšť	rain
těsně	close
obyčejný	common
vzdálený	remote
kapitán	captain
rozhodovat	decide
generál	general
několikrát	several times
roh	corner
d	d
básník	poet
povaha	nature
holka	girl
máma	mother
dokonalý	perfect
jezero	lake
ztrácet	waste
zavést	introduce
přivést	bring
nahradit	replace
palác	palace
rozdělit	split
spokojený	satisfied
ovlivnit	affect
zachránit	rescue
dávka	dose
sovětský	Soviet
uložit	impose
vědecký	scientific
věž	tower
trpět	suffer
sklo	glass
užívat	enjoy
lžíce	spoon
přednost	preference
nadále	continue
podzim	fall
večeře	dinner
mléko	milk
starat	worry
dotknout	touch
dosavadní	existing
plně	fully
vydávat	emit
procházet	go through
uskutečnit	implement
úplný	complete
upozornit	warn
tenkrát	then
předem	in advance
svědek	witness
reforma	reform
branka	goal
chránit	protect
pozor	beware
velitel	commander
verze	version
venku	outdoors
koleno	knee
schod	step
středisko	center
myšlení	thought
strávit	digest
podepsat	sign
dvanáct	twelve
dostatečný	sufficient
složka	component
pobyt	stay
letní	summer
jednak	secondly,
odchod	exit
kost	bone
táta	dad
původ	ancestry
záměr	intention
následek	result
okolo	about
duchovní	spiritual
dlouhodobý	long-term
ostrý	sharp
diskuse	debate
sdružení	association
židle	chair
spisovatel	writer
praktický	practical
víkend	weekend
krize	crisis
odpovědnost	responsibility
odstavec	section
dlaň	palm
klidný	calm
dneska	today
odtud	thence
vydání	release
obecně	general
tichý	silent
deník	diary
mocný	powerful
dáma	checkers
sál	hall
častý	frequent
přístroj	device
zdejší	local
brána	gate
čerstvý	fresh
reklama	ad
pozemek	land
pád	crash
pěkně	fine
poloha	location
Británie	Britain
fotbalový	football
vrchol	top
román	novel
tráva	grass
lék	medicine
převzít	take over
tón	tone
povědět	tell
splnit	fulfill
vina	guilt
nutit	coerce
průměrný	average
oprava	correction
prokázat	show
žlutý	yellow
ihned	immediately
chytit	catch
Škoda	Shame
dávný	old
fyzický	physical
kariéra	career
manželství	marriage
nákup	purchase
rozšířit	expand
atmosféra	atmosphere
případný	prospective
lidový	folk
hala	hall
utéci	flee
uvědomovat	realize
respektive	respectively
máslo	butter
Zdeněk	Zdenek
vyrábět	produce
pomyslet	think
táhnout	drag
přítomný	present
zasáhnout	hit
cigareta	cigarette
suchý	dry
silně	strongly
zloděj	thief
daňový	tax
volební	election
vyplývat	result
Itálie	Italy
hodnocení	reviews
odkud	whence
oficiální	official
popsat	describe
dno	bottom
výrobní	manufacturing
patrně	apparently
zbýt	left over
válečný	war
náboženský	religious
odcházet	go
konstatovat	state
elektronický	electronic
podivný	strange
působení	action
lehce	lightly
reálný	real
samostatný	separate
studený	cold
klíč	key
chléb	bread
nazývat	calling
aplikace	application
dařit	thrive
určený	intended
Robert	Robert
přežít	survive
tmavý	dark
sněmovna	House of Commons
tisk	print
barevný	color
vystupovat	stand out
zničit	destroy
sídlo	seat
aktivní	active
projevovat	show
srovnání	comparison
přečíst	read
časový	temporal
soupeř	rival
alkohol	alcohol
důstojník	officer
ach	oh
hřiště	playground
počasí	weather
zvládnout	manage
lišit	differ
horní	upper
křídlo	wing
povinný	compulsory
zabránit	prevent
děvče	girl
dorazit	arrive
styk	contact
správně	right
školní	school
pravidelný	regular
křeslo	armchair
křičet	shout
knížka	book
přátelský	friendly
umístit	place
hrůza	horror
pevně	firm
okresní	District
postižený	afflicted
vzácný	rare
dech	breath
strategie	strategy
zvyšovat	increase
cokoliv	whatever
děkovat	thank
subjekt	subject
droga	drug
signál	signal
odbor	department
představení	performance
zaznamenat	record
cm	cm
zásadní	essential
Olomouc	Olomouc
nálada	mood
kapela	band
varianta	option
konference	conference
prostý	plain
ochotný	helpful
centrální	central
energetický	Energy
klíčový	key
památka	monument
tajemství	mystery
jev	is in
zpravidla	usually
letiště	airport
nůž	knife
kandidát	candidate
hmota	mass
probudit	wake
středa	Wednesday
pobřeží	coast
káva	coffee
příslušník	member
čtvrt	quarter
vlastnit	own
královský	royal
poplatek	fee
nehoda	accident
úloha	role
pohlédnout	glance
Sparta	Sparta
přijímat	take
rozum	reason
hrubý	rough
připravený	ready
snížení	reduction
divadelní	theatrical
jinde	elsewhere
pátý	fifth
Jana	Jane
jedinec	individual
temný	dark
expozice	exposure
přechod	transition
vzdálenost	distance
doplnit	refill
léčba	treatment
značně	greatly
chudý	poor
údajně	supposedly
třetina	third
odstranit	remove
vyloučit	exclude
seznámit	acquaint
copak	do not you
tehdejší	then
konflikt	conflict
údolí	valley
paže	arm
Miroslav	Miroslav
chrám	temple
narazit	crash
cibule	onions
malíř	painter
rozměr	dimension
babička	grandmother
areál	grounds
test	test
pečlivě	carefully
pokládat	deem
knihovna	library
Milan	Milan
koncepce	conception
soudit	judge
pravidelně	regularly
povést	reputation
zpracování	treatment
Klaus	Klaus
vůně	fragrance
sport	sport
přispět	contribute
členský	member
platný	valid
dluh	debt
vejce	egg
čína	China
blížit se	approach
internetový	web
symbol	symbol
domácnost	household
literární	literary
komunista	Communist
dohromady	together
čtyřicet	forty
realita	reality
rys	feature
osobně	personally
uživatel	user
učení	apprenticeship
linka	line
příspěvek	contribution
zrušit	cancel
mouka	flour
známka	mark
roční	yearly
dostatečně	enough
jih	south
zřejmý	clear
lékařský	medical
lid	people
úsilí	effort
požadovat	demand
pozvat	invite
sednout	sit
spadnout	fall
ročně	per annum
viset	hang
spánek	sleep
trestný	criminal
investiční	Investment
vybraný	selected
onemocnění	illness
přání	wishes
natolik	enough
padat	fall
oběd	lunch
turista	hiker
strašně	awfully
zranění	injury
Ivan	Ivan
porucha	failure
vzhůru	up
zahrnovat	comprise
sbor	chorus
vzdát	give up
zlato	gold
stavět	build
Michal	Michael
sever	north
mimořádný	extraordinary
kopec	hill
spotřeba	consumption
vědec	scientist
udržovat	maintain
toužit	yearn
souviset	related
sezóna	season
špička	tip
pozitivní	positive
čtvrtek	Thursday
vložit	insert
pás	strip
dokončit	finish
rekonstrukce	reconstruction
mír	peace
dohodnout	settle
zaujmout	take
výhodný	profitable
sezona	Season
opera	opera
cizinec	foreigner
mlčet	be silent
vyjadřovat	express
Liberec	Liberec
pořádně	properly
čínský	Chinese
pojišťovna	Insurance
odlišný	different
výměna	exchange
židovský	Jewish
vzdělání	education
slza	tear
rakouský	Austrian
úsek	section
rudý	red
dosahovat	reach
Ing	Ing
zúčastnit	participate
zaměstnání	employment
bankovní	banking
nádherný	gorgeous
pošta	post office
socha	statue
smutný	sad
hlásit	report
naštěstí	fortunately
volit	choose
Anglie	England
kampaň	campaign
okruh	circuit
led	ice
doporučovat	recommending
pochopitelně	naturally
spojovat	splice
výchova	education
báseň	poem
pokles	drop
předat	convey
elektrárna	power station
rovný	straight
slíbit	promise
útočník	forward
výtvarný	plastic
byť	be
dodávka	supply
soused	neighbor
ustanovení	provision
brněnský	Brno
komunistický	Communist
příznivý	favorable
demokracie	democracy
zvýšený	increased
lístek	ticket
váha	weight
linie	line
vteřina	second
rozhodující	critical
zásoba	supply
vítěz	winner
označovat	branding
revoluce	revolution
prospěch	benefit
společenství	community
Rakousko	Austria
jakoby	though
ekologický	ecological
láhev	bottle
letecký	air
trvalý	permanent
přistoupit	accede
elektřina	electricity
trend	trend
připojit	connect
domek	house
vařit	cook
vinný	guilty
výdaj	expenditure
obchodník	businessman
obtížný	difficult
motiv	motif
plnit	perform
kdykoliv	anytime
pojetí	conception
omezit	limit
šťáva	juice
zažít	experience
vzor	pattern
stoupat	rise
slušný	decent
specifický	specific
Irák	Iraq
hrozně	awfully
A	A
opatrně	carefully
nádraží	railway station
vrhnout	cast
obvinit	blame
odnést	carry
divoký	wild
čaj	tea
titul	title
Morava	Moravia
organismus	organism
postupovat	proceed
Richard	Richard
vybírat	choose
ovlivňovat	influence
mírně	gently
nahoře	above
proběhnout	run through
hodný	worthy
zajišťovat	provide
královna	queen
kritika	criticism
fakulta	faculty
pořad	agendas
měkký	soft
prozradit	reveal
fronta	queue
poznání	cognition
Kája	Kája
zásah	intervention
omezení	limitations
příbuzný	related
pojištění	insurance
realizace	realization
prach	dust
sexuální	sexual
kombinace	combination
stáhnout	Download
demokratický	democratic
usmívat se	smile
schválit	approve
zájemce	candidates
blok	block
svazek	volume
fotbalista	footballer
skrývat	hide
zvyk	custom
V	In
vyhnout	dodge
trať	track
soustředit	focus
komora	chamber
mapa	map
účinný	effective
střed	middle
průzkum	exploration
dovolená	holiday
násilí	violence
současnost	present
zajít	go
košile	shirt
založený	founded
LN	LN
mistrovství	championship
obávat	worry
květ	flower
skladba	composition
sazba	rate
souhlas	agreement
doslova	literally
vyřešit	solve
posílat	sent
naproti	opposite
doklad	document
kapacita	capacity
chladný	cool
zločin	felony
P	P
hrob	grave
důvěra	confidence
svátek	feast
umělý	artificial
směs	mix
zaměstnavatel	employer
správní	administrative
obloha	garnish
WWW	WWW
zimní	winter
záznam	record
cz	com
úterý	Tuesday
trestní	criminal
zařadit	classify
dodavatel	contractor
přiblížit	approach
kmen	tribe
soustava	system
klášter	monastery
tiskový	press
bytost	creature
kamenný	stone
x	x
M	M
křesťanský	Christian
hrdina	hero
kritérium	criterion
provedení	performance
cit	emotion
skála	rock
mínit	mean
novina	news
vesmír	space
jádro	core
klobouk	hat
kněz	priest
dole	down
ukončit	terminate
mohutný	massive
plat	salary
prosadit	enforce
obvod	circuit
levný	cheap
ocitnout	find themselves
divit	wonder
částečně	partly
mobilní	mobile
mužstvo	team
zelenina	vegetables
nalézt	find
vládnout	govern
hodnotit	judge
najevo	clear
náhodou	by chance
série	series
dar	gift
rod	genus
individuální	individual
schůzka	meeting
vlastník	owner
mezitím	meanwhile
vybavit	equip
vykřiknout	exclaim
bitva	battle
koukat	watch
tlustý	thick
hluboko	deep
viditelný	visible
ideální	ideal
převážně	predominantly
někam	somewhere
zemědělský	farm
hospoda	pub
podpořit	promote
management	management
Japonsko	Japan
mírný	moderate
Helena	Helena
svědčit	witness
zato	for
ovládat	dominate
efekt	effect
of	of
potravina	foodstuff
mzda	wage
vůdce	leader
jaderný	nuclear
kořen	root
konkurence	competition
polský	Polish
říše	empire
dle	according to
trasa	itinerary
mužský	male
přísný	strict
dospět	grow up
problematika	issue
odhalit	reveal
prohlédnout	inspect
přerušit	interrupt
soulad	harmony
patro	storey
zmínit	mention
vyskytovat se	occur
přenos	transmission
kritický	critical
naprostý	sheer
hromada	pile
chemický	chemical
dočkat	wait
naplnit	fill
poněvadž	because
dav	crowd
proměnit	convert
dvojice	pair
závažný	serious
zbytný	non-essential
budit	draw
odhad	estimate
písek	sand
větev	branch
okres	county
znamení	sign
denní	daily
podél	along
svěřit	entrust
zrcadlo	mirror
Budějovice	Budějovice
hrozný	dreadful
nechávat	leave
sluneční	solar
snášet	suffer
I	I
patrný	noticeable
Vídeň	Vienna
choroba	disease
výklad	interpretation
zóna	zone
prohlášení	statement
vyrovnat	settle
vzrůst	increase
Moskva	Moscow
podstatně	substantially
sláva	fame
oslava	celebration
horský	mountain
vystoupení	appearance
komerční	commercial
jevit	appear
vynikající	outstanding
pramen	source
vrah	killer
zachytit	catch
rovnou	straight
Marek	Marek
uvolnit	release
zaměřit	concentrate
zbytečný	wasted
mechanismus	mechanism
překvapení	surprise
vyvolávat	give rise to
rovina	plane
Afrika	Africa
svatba	wedding
klesnout	drop
ústavní	constitutional
rozšíření	extension
prudce	violently
spodní	lower
všeobecný	general
spolupracovat	cooperate
jedině	Only
negativní	negative
premiéra	premiere
Eva	Eva
hustý	thick
dětství	childhood
hmotnost	weight
profesionální	professional
kalhoty	trousers
platnost	validity
poradit	advise
Karlův	Charles
zvaný	known
varovat	warn
zahlédnout	catch sight
zasmát	laugh
slibovat	promise
prostora	space
zážitek	enjoyment
hospodářství	economy
vyslovit	pronounce
letět	fly
telefonní	phone
oproti	compared to
vyšetřování	investigation
lesní	Forestry
výpověď	notice
uzavřený	closed
sektor	sector
minimální	minimum
popisovat	describe
regionální	regional
správce	administrator
podezření	suspicion
povolení	authorization
sladký	sweet
železný	iron
dokonale	perfectly
obyvatelstvo	population
jednotlivec	single
pravděpodobný	likely
někdejší	former
náboženství	religion
vybavení	equipment
stěžovat	complain
zkoušet	rehearse
málem	nearly
tělesný	physical
získávat	gain
spravedlnost	righteousness
volič	selector
blízkost	nearness
kanál	channel
zajištění	ensuring
podnikání	undertaking
spustit	run
zakázka	commission
překonat	overcome
Vánoce	Christmas
připustit	admit
pokaždé	always
von	out
operační	operating
obrat	turnover
opačný	reverse
dotace	grant
kříž	cross
turnaj	tournament
mořský	marine
předložit	submit
dělit	divide
moment	moment
Julián	Julián
umřít	die
vzápětí	then
zahrát	play
B	B
vyhlásit	announce
filozofie	philosophy
zasloužit	deserve
písmeno	letter
dálka	distance
zvést	rumors
zkrátka	shortly
aktuální	current
přikývnout	nod
městečko	town
cyklus	cycle
pověst	reputation
zeman	thane
cestující	passengers
sebrat	pick
vnitro	Interior
počítačový	computer
stanovený	set
hnědý	brown
princ	prince
navzájem	each other
označení	designation
útvar	formation
Pardubice	Pardubice
zábava	entertainment
novinka	news
shromáždění	rally
odvézt	take away
císař	emperor
kočka	cat
tenký	thin
vytvoření	creation
díra	hole
herečka	actress
zdaleka	by far
Labe	Elbe
divize	division
sáhnout	touch
čtrnáct	fourteen
přístav	harbor
trocha	little
břicho	belly
lázeň	bath
maximální	maximal
složit	fold
vědomý	conscious
prohlížet	view
zamířit	aim
let	flight
strop	ceiling
plášť	sheathing
tvrzení	claim
fotbal	football
populární	popular
plánovat	plan
Kateřina	Catherine
pachatel	offender
plakat	cry
náměstek	deputy
architektura	architecture
porazit	beat
realizovat	implement
hasič	fireman
úmysl	intent
naposledy	last
popis	description
ovoce	fruit
příchod	advent
Zlín	Zlin
příkaz	command
veletrh	fair
výzva	challenge
Adam	Adam
výnos	return
hlad	hunger
přehled	summary
skládat	compose
tudíž	therefore
publikum	audience
sklenice	jar
věčný	everlasting
Ježíš	Jesus
okolní	surrounding
teta	aunt
odpovídající	appropriate
síň	hall
uznat	recognize
vojsko	army
vánoční	Christmas
základna	base
sehnat	get
vykládat	construe
prohrát	lose
socialistický	socialist
trápit	worry
účinnost	effectiveness
odsoudit	convict
bar	bar
chybit	miss
mládež	youth
obejít	circumvent
ba	nay
nikde	nowhere
tanec	dance
zpočátku	initially
vchod	entrance
závazek	commitment
zdůraznit	emphasize
tvářit	look
dálnice	highway
plátek	slice
jindy	another time
postarat	take care
Havel	Havel
tuk	fat
odložit	postpone
pořádat	hold
nákladní	Freight
stříbrný	silver
nakrájet	slice
blesk	lightning
podezřelý	suspect
jelikož	as
biskup	bishop
podobat	resembling
vyšetření	examination
expert	expert
ochranný	protective
kg	kg
předvést	demonstrate
agent	agent
statek	farmhouse
strašný	frightful
růžový	pink
včerejší	yesterday
úspěšně	successfully
titulus	titulus
svítit	shine
rostoucí	growing
Slavia	Slavia
záviset	depend
pokuta	fine
relativně	comparatively
hledání	search
dělník	worker
teda	therefore
pohnout	move
uniknout	escape
kontrolovat	control
prožít	live through
požár	fire
usadit	settle
mířit	aim
závěrečný	final
květina	flower
prudký	sharp
Tim	Tim
planeta	planet
tok	flow
citlivý	sensitive
usnout	go to sleep
opravdový	real
detail	detail
římský	Roman
vysvětlení	explanation
přijetí	adoption
překážka	hurdle
OSN	UN
senát	senate
zkoumat	examine
sklad	warehouse
Washington	Washington
klesat	decline
Paul	Paul
podnět	stimulus
uspořádání	arrangement
zpěv	singing
pracoviště	workplace
rozpor	rift
právník	lawyer
Řím	Rome
pochybovat	doubt
vybudovat	build
hladký	smooth
bolet	hurt
obdržet	receive
zákaz	ban
zavedení	introduction
směřovat	lead
federální	federal
usilovat	seek
člun	boat
snižovat	lower
Slovensko	Slovakia
kouč	Coach
věrný	faithful
Česko	Czech
dopad	impact
zázrak	miracle
kamera	camera
svědomí	conscience
náčelník	chief
odvaha	courage
architekt	architect
výkonný	executive
písnička	song
budoucno	future
zvítězit	win
vážit	weigh
tendence	trend
nutnost	need
drát	wire
železniční	railway
poezie	poetry
Tom	That
zakázat	prohibit
div	wonder
očekávání	expectations
vedlejší	minor
vysoce	highly
utíkat	run
redakce	editorial staff
uslyšet	hear
vozík	trolley
Ústí	Estuary
nápis	inscription
těžce	heavily
obal	package
pohár	cup
argument	argument
pozadí	background
šedý	gray
dramatický	dramatic
vzbudit	arouse
litovat	regret
skrz	through
anděl	angel
povodeň	flood
španělský	Spanish
heslo	password
včas	on time
veselý	hilarious
komedie	comedy
vyjádření	expression
vrchní	chief
stanovisko	opinion
dostupný	available
náhoda	accident
sýr	cheese
nasadit	put on
in	in
odvolat	appeal
Králová	Králová
omyl	mistake
jednotný	single
přítelkyně	girlfriend
poznatek	finding
řecký	Greek
fanoušek	fan
finále	finals
technologický	technological
duševní	mental
pohádka	tale
zaslechnout	overhear
ČTK	ČTK
výrok	verdict
cestovní	travel
měřit	gauge
zkušený	experienced
nahý	naked
vězeň	prisoner
kupovat	buy
vyměnit	replace
psaní	writing
funkční	functional
družstvo	cooperative
kresba	drawing
podpis	signature
továrna	factory
F	F
třikrát	thrice
trávit	digest
vystavit	issue
pistole	gun
mládí	youth
podklad	foundation
přivézt	carry
start	start
těsto	dough
ústřední	central
zadržet	withhold
Miloš	Miloš
rozhodování	decision
zvyklý	accustomed
navrhovat	suggest
šestý	sixth
drama	drama
upravit	adjust
prvý	first
scházet	meet
tvůrce	creator
T	T
zasedání	session
album	album
R	R
plzeňský	Pilsner
stihnout	catch
opřít	rest
měření	measurement
užitečný	helpful
dopoledne	morning
financování	funding
standardní	standard
kráčet	stride
oblečení	clothing
rozkaz	command
jedenáct	eleven
efektivní	effective
navzdory	despite
mateřský	maternal
zpěvák	singer
četný	numerous
vyzvat	invite
poptávka	demand
vymyslet	invent
jednoznačně	positively
pilot	pilot
vydělat	earn
nárůst	increase
ženská	woman
třebaže	although
privatizace	privatization
seriál	series
odměna	reward
vyvíjet	develop
divný	strange
ložnice	bedroom
sval	muscle
přesvědčení	conviction
Berlín	Berlin
marně	in vain
kovový	metal
tržní	market
vyhodit	blow
jemně	gently
omáčka	sauce
beton	concrete
takřka	almost
upozorňovat	alert
podnikatelský	business
vyplatit	pay off
demokrat	democrat
lžička	spoon
Daniel	Daniel
koncentrace	concentration
obsadit	occupy
obvinění	accusation
tuna	ton
vyhláška	notice
bytový	residential
ráz	nature
vzorek	sample
plot	fence
poradce	adviser
doprovázet	accompany
umírat	be dying
Československo	Czechoslovakia
naslouchat	listen
houba	fungus
pevnost	strength
vyrůst	grow
zařídit	arrange
prožívat	experience
obrazovka	screen
pozoruhodný	remarkable
sníst	eat
česnek	garlic
populace	population
hradec	hradec
investovat	invest
kapitál	capital
dopředu	forward
vstupní	input
minimálně	at least
otvor	opening
nazvat	call
definovat	define
proniknout	penetrate
určovat	determine
koalice	coalition
prohlídka	tour
hloupý	stupid
I.	I.
naznačovat	denote
sféra	sphere
paprsek	beam
orientace	orientation
přecházet	pass
zemědělství	agriculture
globální	global
ukrást	steal
natáhnout	stretch
ponechat	leave
sedadlo	seat
trouba	oven
kout	nook
týkající	on
zlepšit	enhance
blázen	crazy
kyselina	acid
naznačit	suggest
rus	rus
gesto	gesture
sousední	neighboring
osa	axis
potvrzovat	confirm
školství	education
štáb	staff
potrava	aliment
kov	metal
absolutní	absolute
brzký	early
stadión	stadium
účastnit	participate
odvést	divert
rozumný	reasonable
skočit	jump
Lucie	Lucie
nato	on it
uspět	Succeed
výborný	excellent
popřípadě	or
naleznout	find an
uvěřitelný	believable
jenomže	But
lůžko	bed
zahájení	initiation
česko	Czech
Harry	Harry
plod	fetus
vyjet	start
pláž	beach
takovýto	such
centimetr	centimeter
zanechat	leave
hloubka	depth
následný	follow-up
Michael	Michael
špinavý	dirty
žid	Jew
novela	short story
odehrát	play
plnění	performance
uspořádat	organize
zranit	hurt
daleký	far
palivo	fuel
stavit	come by
strategický	strategic
důchod	retirement
stan	tent
ulička	alley
nález	finding
hoch	boy
vypadnout	fall out
vyvinout	evolve
NHL	NHL
točit	spin
zavrtět	shake
dárek	gift
rytmus	rhythm
posádka	crew
ČT	CT
falešný	false
desetiletí	decade
Izrael	Israel
obracet	turn
dílna	workshop
pepř	pepper
podotknout	remark
radní	councilor
výstup	output
náhrada	replacement
tepelný	thermal
sex	sex
povolit	permit
dopustit	commit
obecní	municipal
překročit	exceed
vyrobit	produce
hnát	drive
kolej	college
morální	moral
scénář	screenplay
hrozba	threat
výlet	outing
polévka	soup
skleněný	glass
brankář	keeper
hovor	call
akademie	academy
světlý	light
charakteristický	characteristic
poledne	noon
tuzemský	home
proslulý	renowned
senátor	senator
chodník	walkway
měsíční	monthly
přirozeně	naturally
provázet	go along
jednoduše	simply
nakrájený	sliced
plamen	flame
lidstvo	humanity
aspekt	aspect
rozvíjet	develop
odrážet	reflect
parametr	parameter
střílet	shoot
ohrozit	compromise
svah	rise
přihlásit	sign in
zapsat	write
dohled	surveillance
nezaměstnanost	unemployment
živit	nurture
provozní	operating
uplatňovat	exercise
pokyn	instruction
obyčejně	usually
přestávka	break
advokát	lawyer
slavnostní	festive
zastupitelstvo	council
katolický	Catholic
hokejista	hockey player
úcta	esteem
jeskyně	cave
nábytek	furniture
Polsko	Poland
zlobit	annoy
důl	mine
podání	submissions
ručení	liability
vzniklý	formed
inženýr	engineer
přeprava	transportation
ropa	oil
jablko	apple
jeviště	stage
sloup	column
měna	currency
živočich	animal
brýle	eyeglasses
D	D
zahynout	perish
Španělsko	Spain
posílit	strengthen
Dick	Dick
vlastnictví	property
dostatek	enough
úspora	saving
olomoucký	Olomouc
dvacátý	twentieth
vstupovat	enter
vzájemně	mutually
dotýkat	touch
důraz	emphasis
skrytý	hidden
míč	ball
zdůrazňovat	emphasize
poblíž	near
pravděpodobnost	probability
slib	promise
Jim	Them
O	About
přijatelný	acceptable
postihnout	affect
nenávidět	hate
plukovník	colonel
pronést	interject
salát	salad
moravský	Moravian
porážka	defeat
poškodit	damage
plátno	screen
verš	verse
mínění	opinion
žaludek	stomach
uplatnit	enforce
cvičení	exercises
podruhé	secondly
srovnat	level
dotaz	inquiry
charakteristika	characteristic
povolání	profession
překlad	translation
přednáška	lecture
vyskočit	jump
Ladislav	Ladislav
Stanislav	Stanislav
Celsius	Celsius
nepochybně	doubtless
olympijský	Olympic
prázdniny	holidays
řetězec	String
zlepšení	improvement
zveřejnit	published
S	S
aj	and
ranní	morning
vypracovat	develop
volně	freely
zavřený	closed
zvedat	lift
odehrávat	place
respektovat	respect
milenec	lover
čára	line
zlo	evil
zarazit	stop
Indie	India
nemovitost	property
vzdělávání	education
pořídit	buy
vyhovovat	suit
půlnoc	midnight
neboli	or
Bill	Bill
příloha	annex
tamní	local
dosažení	attainment
publikace	Publications
rozvod	divorce
spis	file
tragedie	Tragedy
vlhký	wet
obránce	defender
logický	logical
mnohdy	sometimes
žádoucí	desirable
užít	enjoy
talíř	plate
pravomoc	competence
dýchat	breathe
šedesát	sixty
obdobný	analogical
směrnice	directive
maska	mask
odhadovat	guess
taška	bag
chalupa	cottage
nařídit	order
propustit	sack
souboj	duel
dědeček	grandfather
E	E
ústava	constitution
zvolat	exclaim
hřbitov	cemetery
uvěřit	believe
ohromný	huge
žijící	living
přimět	bring
etapa	phase
shoda	agreement
samota	solitude
bydlení	housing
holčička	baby girl
vztahovat	relate
civilizace	civilization
pásmo	zone
silniční	road
pobočka	branch
řádek	line
nápadný	noticeable
spravedlivý	righteous
nova	nova
III	III
oddíl	Section
podrobnost	detail
stolek	table
kapka	drop
výjimečný	exceptional
lampa	lamp
hmotný	physical
zapojit	plug in
masový	mass
mívat	blacking
ocenit	appreciate
výhra	win
kdokoliv	anyone
ztracený	lost
chytrý	clever
odpustit	forgive
získaný	acquired
Jakub	Jacob
vyzkoušet	test
hlídat	watch
posléze	then
ušetřit	save
pomalý	slow
zabezpečení	security
nástup	boarding
místopředseda	vice-chairman
prosazovat	assert
vázat	bond
akt	act
očekávaný	expected
kabát	coat
rozsudek	verdict
setkávat	meet
holý	bare
oslovit	address
vidění	vision
výbuch	explosion
lhát	lie
skvrna	stain
pytel	sack
Svoboda	Freedom
zrak	sight
princezna	princess
přinejmenším	at least
uhlí	coal
pochopení	understanding
pořádný	good
paluba	deck
vykonávat	exercise
kufr	suitcase
bohatství	wealth
přístupný	accessible
zaměřený	focused
potěšit	please
oceán	ocean
hřích	sin
rozšířený	widespread
index	index
pocítit	experience
dovědět	learn
schodiště	staircase
skříň	cupboard
výprava	expedition
charakterizovat	characterize
mlha	fog
natočit	shoot
turistický	tourist
tržba	revenue
vyšetřovatel	investigator
úder	strike
San	San
mimořádně	extremely
definitivně	finally
pořadí	order
ledový	iced
příznak	symptom
Špidla	Spidla
tempo	pace
formální	formal
sebevražda	suicide
ha	ha
maximum	maximum
tančit	dance
komentovat	comment
narození	birth
přispívat	contribute
domluvit	agree
stydět	ashamed
Asie	Asia
čest	honor
nadšení	enthusiasm
katastrofa	disaster
krádež	theft
letoun	airplane
podrobný	detailed
poškození	damage
debata	debate
hokejový	hockey
postavený	built
krabice	boxes
kritik	critic
louka	meadow
pára	steam
zírat	goggle
zemský	earth
kráva	cow
pokrok	progress
sluha	servant
chata	cottage
portrét	portrait
stávající	current
plíce	lungs
uklidnit	soothe
večerní	evening
taneční	dancing
vzhled	appearance
prodejna	shop
dolní	lower
prádlo	clothes
asociace	association
slepý	blind
vášeň	passion
zapálit	ignite
protest	protest
rovnováha	balance
odvětví	branch
cestovat	travel
přenést	transfer
složení	composition
sedmý	seventh
komplex	complex
mrtvola	corpse
komisař	commissioner
otevírat	opening
objednat	order
políbit	kiss
liberecký	liberecký
sklep	cellar
království	kingdom
inspektor	inspector
primátor	Lord Mayor
stanovení	determination
komplexní	complex
doporučit	recommend
psychický	psychic
obnova	restoration
spolek	guild
vize	vision
schovat	hide
děj	action
doplňovat	supplement
Hana	Blame
potomek	descendant
žaloba	action
církevní	church
legenda	legend
neštěstí	unhappiness
zaznít	heard
kavárna	cafe
laboratoř	lab
mrak	cloud
fantazie	fantasy
bouře	storm
vítat	welcome
zapotřebí	required
útěk	escape
šířit	spread
čtení	reading
koberec	carpet
oděv	clothing
Bush	Bush
provozovat	run
spolehlivý	reliable
zdravotnictví	Health
poušť	desert
úvod	introduction
každodenní	daily
kouřit	smoke
opírat	lean
koupelna	bathroom
výhradně	only
ráj	paradise
lhůta	deadline
režie	Directing
čelit	counter
terén	terrain
způsobovat	cause
námořní	seagoing
přiznávat	grant
opuštěný	abandoned
talent	talent
posluchač	listener
vlast	country
uniforma	uniform
venkov	country
chráněný	protected
vysílání	broadcasting
zapomínat	forget
vysílat	carry
líto	sorry
NATO	ON IT
post	post
mediální	Media
reprezentace	representation
vila	villa
vztek	rage
procházka	walk
peklo	hell
sklon	slope
kritizovat	criticize
jezdec	rider
lavice	bench
ukládat	store
veřejně	in public
používaný	used
slavnost	celebration
hlasitě	loud
rekord	record
standard	standard
brambora	spud
reklamní	advertising
běh	run
pěst	fist
přehlídka	parade
vyprávění	story
běžně	ordinarily
zjištění	finding
zpracovat	process
Vysoký	High
výpočet	calculation
vyhýbat	avoiding
snídaně	breakfast
tlačit	push
zvyknout	accustom
e	e
rozdílný	different
zásluha	merit
spořitelna	savings bank
Francouz	Frenchman
proměna	transformation
sbírat	collect
iniciativa	initiative
kontext	context
nerv	nerve
spojenec	ally
unavený	weary
milost	reprieve
čistě	cleanly
vystřídat	relieve
lev	lion
mince	coin
nádrž	tank
kterýkoliv	either
nápoj	beverage
G	G
rodný	home
utrpení	suffering
zraněný	wounded
spěchat	hurry
prominout	pardon
nádoba	vessel
bledý	pale
líbat	kiss
vypít	drink
osolit	salted
nutně	necessarily
ostře	sharply
integrace	integration
jakkoliv	however
znění	amended
Antonín	Antonín
strážník	officer
zastupitel	councilor
Blesk	Lightning
stranou	aside
devadesátý	ninetieth
záření	radiation
milostný	amatory
jarní	spring
intenzívní	intensive
obdivovat	admire
strčit	poke
plánovaný	planned
organizátor	organizer
pochybnost	question
zvolna	slowly
Lukáš	Luke
maximálně	maximally
lézt	climb
kouř	smoke
mokrý	wet
oprávněný	authorized
třást	shake
hořet	burn
uplatnění	use
lokalita	locality
obálka	cover
valný	Valný
výuka	tuition
absolvovat	graduate
utrpět	suffer
opozice	Opposition
vir	Virus
nedělní	Sunday
náhlý	sudden
rozhodčí	referee
pero	pen
ač	though
institut	institute
pěstovat	grow
upadnout	fall
idea	idea
námět	theme
slavit	celebrate
vylézt	climb
obnovit	restore
ustoupit	retreat
kontrolní	control
opouštět	leaving
hrabě	earl
rozdělení	distribution
uplynulý	past
krevní	blood
počínat	act
modlitba	prayer
nízko	low
požadovaný	required
smrtelný	deadly
betonový	Concrete
poštovní	postal
vzadu	back
spolupracovník	co-worker
omezovat	limit
surovina	raw material
kůra	peel
úvodní	opening
hodinky	watch
pohlaví	sex
nynější	present
práh	threshold
kouzlo	magic
hluk	noise
hrdlo	throat
tajemník	secretary
zalít	suffuse
medaile	medal
mez	limit
zatknout	arrest
zápis	writing
krutý	cruel
jednota	unity
L	L
mizet	disappear
zbytečně	unnecessarily
protokol	protocol
vynést	bring
získání	acquisition
nenávist	hatred
malba	painting
navázat	establish
šaman	shaman
humor	humor
ostravský	Ostrava
podnikový	corporate
výskyt	occurrence
objev	discovery
organizační	Organizational
ukazatel	pointer
územní	territorial
rybník	pond
likvidace	liquidation
používání	use
vítězný	winning
hromadný	mass
stezka	trail
potok	creek
zbývající	remaining
komunikační	Communications
platební	payment
znova	anew
tkáň	tissue
studium	study
angličtina	English
automaticky	automatically
měřítko	scale
jazykový	language
klín	wedge
lahev	Bottle
šampionát	Championships
výhled	outlook
úžasný	amazing
burza	exchange
snést	endure
záruka	warranty
důkladně	thoroughly
kabinet	cabinet
vyspělý	mature
čestný	honest
jaksi	sort of
orchestr	orchestra
ujistit	reassure
panna	virgin
módní	fashionable
šetřit	save
zrušení	repeal
bomba	bomb
lež	lie
zpěvačka	singer
nařízení	regulation
vyžádat	ask
tramvaj	streetcar
cenový	price
přestávat	subside
radit	advise
představenstvo	Board of Directors
biologický	biological
ocelový	steel
bazén	swimming pool
móda	fashion
donutit	coerce
zákonný	statutory
spoj	link
těsný	close
smutek	sadness
devátý	ninth
psychologický	psychological
izraelský	Israeli
mj	ia
výročí	anniversary
hlídka	patrol
inscenace	productions
měnový	currency
šílený	crazy
stoupnout	rise
průkaz	card
smluvní	contractual
dokumentace	documentation
rozloučit	say goodbye
oznámení	announcement
suma	sum
existující	existing
nazvaný	called
trvale	permanently
zdravotnický	health
raný	early
W	W
osmý	eighth
naklonit	tilt
založení	foundation
kostka	cube
trénink	training
opilý	drunk
tuhý	tough
úzkost	anxiety
přínos	benefit
vlákno	fiber
libra	pound
nahlas	aloud
kvalifikace	qualification
nakladatelství	publishing house
ozbrojený	armed
plynout	flow
váhat	hesitate
brada	chin
pohodlný	comfortable
pruh	streak
sahat	reach
střela	missile
tvůrčí	creative
srazit	shrink
šok	shock
zřídit	establish
parta	crew
vytváření	creation
léčit	treat
Masaryk	Masaryk
autorita	authority
mobil	cell phone
navštěvovat	visit
zašeptat	whisper
historik	historian
řídící	directional
stabilita	stability
napůl	half
skok	jump
zmocnit	empower
ujmout	take
výkonnost	efficiency
zastřelit	shoot
předek	forefather
digitální	digital
sestava	Report
specializovaný	Specialized
úhel	angle
obřad	ceremony
poškozený	Corrupted
rušit	disturb
nalít	infuse
palec	thumb
Švejk	Svejk
dění	events
pátrat	search
položka	item
pohledávka	claim
přísně	strictly
kdosi	Who are you
záběr	shot
disciplína	discipline
magistrát	City Hall
všímat	notice
připouštět	conceding
akcionář	shareholder
interiér	interior
obtíž	difficulty
Brit	Briton
Brusel	Brussels
podvod	fraud
konkurenční	competitive
kaple	chapel
projet	ride
přitahovat	attract
kožený	leather
romantický	romantic
Maďarsko	Hungary
zoufalý	desperate
balíček	package
podlehnout	succumb
indický	Indian
vtip	joke
respekt	respect
oficiálně	officially
nesmysl	nonsense
pohoda	contentment
pochopitelný	understandable
upřímně	sincerely
psychologie	psychology
šedesátý	sixtieth
zmatek	confusion
šálek	cup
těleso	body
pult	counter
infekce	infection
přizpůsobit	adapt
ředitelka	directress
údržba	maintenance
způsobený	due to
lehnout	lie down
učitelka	teacher
tradičně	traditionally
přátelství	friendship
líčit	narrate
pokrčit	shrug
výběrový	selective
hluboce	profoundly
moudrý	wise
činitel	factor
odhadnout	estimate
Švýcarsko	Switzerland
malovat	paint
miska	bowl
pití	drinking
t	T
diskutovat	debate
potenciál	potential
vajíčko	egg
dovolovat	allowing
logistický	logistic
mráz	frost
oblek	suit
pařížský	Parisian
rozbít	smash
zpětný	reverse
narozeniny	birthday
otcův	his father
zjišťovat	identify
mísa	bowl
doporučení	recommendation
tisknout	press
bezpečně	safely
organizovat	organize
kdežto	while
mechanický	mechanical
definice	definition
desky	Plates
venkovský	country
zákoník	Code
fórum	Forum
optimální	optimum
porušení	violation
ovládnout	dominate
pohřeb	funeral
pravdivý	true
potenciální	potential
věřící	believer
asistent	assistant
rukopis	manuscript
umístění	location
interpretace	interpretation
kauza	case
gymnázium	high school
podzemní	underground
zřetelně	clear
Garp	Garp
pánev	pan
vlevo	left
zabrat	occupy
analytik	analyst
zdánlivě	ostensibly
K	To
kontinent	continent
mimochodem	by the way
Roman	Roman
střídat	alternate
napít se	drink
obléci	dress
kloub	joint
ukončení	termination
výkřik	outcry
hlasování	voting
doposud	yet
pláč	crying
neustálý	unceasing
pleť	complexion
stranický	partial
zvát	invite
server	Server
vyřídit	deal with
Dvořák	Dvorak
házet	throw
šestnáct	sixteen
postupný	progressive
osmnáct	eighteen
statistika	statistics
písmo	font
inflace	inflation
bezpečí	safety
dokazovat	argue
modlit se	pray
vlk	wolf
legrace	fun
Peter	Peter
půjčka	loan
stáří	age
štíhlý	slim
vpravo	right
záhy	soon
odvolání	appeal
účetní	accountant
užívání	usage
nejenom	not only
hezky	nicely
oblouk	arch
porovnání	comparison
spotřebitel	consumer
iluze	illusion
uzavírat	conclude
postoupit	to advance
zopakovat	repeat
lákat	lure
strýc	uncle
doopravdy	really
kaplan	chaplain
třináct	thirteen
popadnout	grab
hejtman	governor
prs	breast
stisknout	press
automobilový	motor
nehet	fingernail
kývnout	nod
ukázka	Sample
konkurs	bankruptcy
kníže	prince
roztok	solution
přeložit	translate
spokojenost	satisfaction
ubohý	wretched
schůze	meeting
bezprostřední	close
strhnout	tear down
pokračování	sequel
poslanecký	deputy
čert	devil
čili	or
jedinečný	unique
rajče	tomato
zdarma	free
konto	account
logika	logic
opravit	fix
frekvence	frequency
náhodný	random
pouštět	run
králík	rabbit
seminář	workshop
křižovatka	intersection
plech	sheet
ocel	steel
meč	sword
pardubický	Pardubice
kabina	cabin
kanada	Canada
regulace	regulation
sukně	skirt
téci	flow
kulatý	round
Rudolf	Rudolf
úleva	relief
švédský	Swedish
dlouhodobě	long term
emise	emission
paprika	pepper
složený	composite
propadnout	fail
fotograf	photographer
posunout	move
salón	salon
tunel	tunnel
večírek	party
průvodce	guide
podrobně	in detail
tah	move
skladatel	composer
budovat	construct
izolace	isolation
Novák	Novak
prášek	powder
využívání	exploitation
hospodaření	economy
prapor	ensign
tvrdě	harshly
desátý	tenth
napadat	challenge
zlomit	break
častě	often
nula	zero
panovat	reign
prezentovat	present
radikální	radical
úraz	accident
pořadatel	organizer
středověký	medieval
chudák	wretch
n	n
stížnost	complaint
záchranný	rescue
svědectví	witness
pata	heel
přesunout	move
vyslat	dispatch
vyslechnout	hear
hůl	staff
kopie	copy
střelec	shooter
koš	basket
H	H
profese	profession
vsadit	wager
náhradní	substitute
hokej	hockey
listina	list
stařec	old man
producent	producer
tragický	tragic
vklad	deposit
ohlásit	announce
transakce	transaction
věznice	jail
bít	beat
dbát	heed
kompletní	complete
software	software
hmyz	insects
osamělý	lonely
záchrana	rescue
právnický	legal
inteligentní	intelligent
pochod	march
cela	cell
únava	fatigue
vtom	in it
zjevně	evidently
doprovod	accompaniment
bilance	balance
zklamat	disappoint
ohrožení	threat
ohrožovat	threaten
kat	hangman
zásadně	basically
povídka	story
manželský	married
vnímání	perception
myš	mouse
Mary	Mary
potěšení	pleasure
napřed	first
tajemný	mysterious
hájit	defend
jídelna	dining room
prezidentský	presidential
had	snake
mlčky	silently
prodejní	sales
kolektivní	collective
rozhlas	radio
přestěhovat	move
klinický	clinical
špičkový	top
následně	then
pusa	kiss
teoretický	theoretic
psací	Writing
dusit	suffocate
rozhlédnout	look around
Jaromír	Jaromír
okamžitý	instant
maďarský	Hungarian
Joe	Joe
šedivý	gray
dovednost	skill
znalec	expert
Ludvík	Lewis
stráž	guard
převést	Convert
odstranění	removal
schéma	scheme
Homer	Homer
lov	hunting
personál	staff
platba	payment
výtah	elevator
and	and
Austrálie	Australia
společník	companion
parlamentní	parliamentary
porod	childbirth
profil	profile
rozšiřovat	circulate
odpovědný	responsible
přenášet	transfer
obžalovaný	defendant
medvěd	bear
sledování	observation
určení	designation
James	James
komplikace	complication
předvádět	parade
komunita	community
nápadně	noticeably
nejistota	uncertainty
mýlit	wrong
slovensko	Slovakia
udělit	grant
výzkumný	Research
koření	spices
pociťovat	feel
puška	rifle
primární	primary
rodit	bear
rezerva	reserve
balík	package
vypravit	dispatch
játra	liver
dodržovat	follow
otevření	opening
arabský	Arabic
čtvrtina	quarter
hádat	guess
oženit	marry
švýcarský	Swiss
luxusní	luxury
úrokový	Interest Rate
předstírat	feign
klinika	clinic
polní	field
poslání	mission
trůn	throne
krásně	beautifully
automatický	automatic
zasahovat	encroach
působnost	activity
uznávat	acknowledge
nakupovat	buy
sdělení	communication
teroristický	terrorist
londýnský	London
prodejce	vendor
úřední	official
vagón	wagon
IV	IV
péci	bake
sobotní	Saturday
coby	what would
použitý	used
laskavý	kind
stabilní	stable
ozývat	reverberate
rozběhnout	run
tyč	rod
upravený	adapted
cizina	foreign countries
lord	lord
pokladna	box office
pršet	rain
objektivní	objective
redaktor	editor
kohout	rooster
světelný	light
terorista	terrorist
vděčný	thankful
vývoz	export
písemný	written
štít	shield
papírový	papery
radovat	rejoice
alternativa	alternative
motivace	motivation
obzor	horizon
krvavý	bloody
priorita	priority
koupě	purchase
jed	poison
perspektiva	perspective
zamilovat	love
spáchat	commit
Japonec	Japanese
zaměření	focus
pochyba	doubt
vyznačovat	distinguish
Jihlava	Jihlava
opatřit	provide
tekutina	fluid
výslech	interrogation
irácký	Iraqi
přejet	run over
rukáv	sleeve
rýže	rice
emoce	emotion
související	Related
spoléhat	rely
licence	license
odkaz	link
zářit	shine
kyslík	oxygen
vskutku	indeed
zacházet	treat
stánek	stand
metrum	meter
peněžní	cash
svíčka	candle
kapitálový	capital
přibýt	accrue
dovoz	import
obejmout	hug
půjčit	lend
všední	everyday
jízdní	mounted
trávník	lawn
vynořit	emerge
vystavovat	exhibit
komentář	comment
medicína	medicine
zvukový	audible
mýtus	myth
zpravodajský	News
zastávat	stand
jednoznačný	clear
odrůda	variety
rozlišovat	distinguish
hřbet	spine
upřímný	honest
sdílet	Share
pozorování	observation
zřídka	rarely
výborně	great
zaútočit	attack
bezprostředně	immediately
nabýt	acquire
zakladatel	founder
historka	story
omlouvat	apologize
protivník	adversary
Jindřich	Henry
karlovarský	Carlsbad
koneckonců	after all
operátor	operator
poranění	injury
střet	clash
drsný	rough
jakožto	as
porušit	violate
pach	odor
pohlavní	sexual
sporný	controversial
ves	village
uchopit	grasp
přidávat	add
vyvést	Remove
ďábel	devil
osmdesát	eighty
provozovatel	operator
vypovídat	testify
dobro	good
éra	era
běhat	run
záplava	flooding
prezentace	Presentation
vykazovat	exhibit
převod	transfer
oddělit	separate
vitamín	vitamin
zakládat	post
bejt	Beit
čeština	Czech
pronikat	permeate
prevence	prevention
recept	recipe
hračka	plaything
servis	service
vedený	led
brambor	potato
miláček	sweetheart
navazovat	continue
koule	globe
křehký	brittle
oblak	cloud
William	William
nervový	nervous
vylučovat	secrete
dojet	reach
křesťan	Christian
konkrétně	concretely
jihočeský	jihočeský
pálit	fire
poklad	treasure
minout	overpass
mletý	ground
prsten	ring
dobrodružství	adventure
papež	pope
vyrovnaný	balanced
terapie	therapy
Gross	Gross
Charles	Charles
usoudit	infer
všeobecně	universally
ideál	ideal
mírový	Peace
pracující	working
bojový	fighting
civilní	civil
kdesi	where are you
ležící	lying
spektrum	spectrum
uznání	recognition
postrádat	lack
energetika	energetics
manipulace	manipulation
udeřit	strike
dialog	dialogue
Telecom	Telecom
opatrný	cautious
zbylý	residual
limit	limit
nasazení	use
rozpaky	embarrassment
rám	frame
sehrát	play
inteligence	intelligence
Hitler	Hitler
loket	elbow
odpůrce	respondent
poslechnout	listen
vytvořený	created
podléhat	be subject to
Švédsko	Sweden
originální	original
Kristus	Christ
pozorně	attentively
šířka	width
keř	bush
Polák	Pole
Bratislava	Bratislava
hlasovat	vote
minimum	minimum
řemeslo	craft
odjíždět	leave
bankovka	banknote
porce	serving
příznivec	well-wisher
vzdělávací	educational
záliv	gulf
zatížení	load
posuzovat	judge
plavat	swim
hlína	clay
stěží	barely
mrzet	vex
sňatek	marriage
atraktivní	attractive
sídliště	housing estate
uplynout	elapse
infrastruktura	infrastructure
Stalin	Stalin
hudebník	musician
statistický	statistic
báze	base
major	major
uchazeč	applicant
narozený	born
alternativní	alternative
skončení	completion
ČEZ	CEZ
normálně	normally
protestovat	protest
vonět	smell
významně	significantly
posvátný	sacred
mlýn	mill
otáčet	rotate
tvor	creature
barokní	baroque
citronový	Lemon
námitka	objection
řetěz	chain
upravovat	edited
ekonom	economist
koncern	concern
Max	Max
sestavit	assemble
záloha	backup
mládě	cub
obliba	popularity
osada	settlement
podzimní	autumnal
posoudit	judge
měsíčně	per month
prohlašovat	claim
chod	run
usednout	sit down
dozadu	backwards
Filip	Philip
unést	abduct
trpělivě	patiently
zahrnout	include
anglicky	English
havárie	crash
sedmdesátý	seventieth
čtvrtletí	quarter
filozof	philosopher
kdepak	bloody likely
uvařit	cook
Žid	Jew
rádio	radio
tajit	concealing
poznávat	recognize
sundat	take down
reprezentant	representative
rozjet	ramp
dostavit	arrive
experiment	experiment
padesátý	fiftieth
železnice	railway
integrovaný	integrated
tank	tank
závazný	obligatory
citovat	quote
skandál	scandal
zmínka	mention
přelom	turn
vyhovět	comply
zčásti	partly
proboha	for heaven's sake
rytíř	knight
vstávat	rise
lokální	local
dvojí	dual
náplň	filling
příčka	partition
Vltava	Vltava
pot	sweat
odvrátit	divert
probrat	talk over
vyšetřovat	investigate
postižení	infliction
příjemně	pleasantly
hradba	wall
kód	code
rumunský	Romanian
van	van
dej	give
přinutit	force
Thomas	Thomas
ověřit	check
trefit	hit
vzkaz	message
parkoviště	parking lot
výživa	nutrition
omluvit	excuse
plochý	flat
Sofie	Sofia
pokrýt	cover
východisko	starting point
osmdesátý	eightieth
vývar	broth
molekula	molecule
opoziční	opposite
schránka	mailbox
cca	ca.
dík	thanks
riskovat	risk
pasus	pasus
jmenovaný	nominative
rakovina	cancer
benzín	gasoline
ponorka	submarine
Egypt	Egypt
chůze	walk
intenzita	intensity
mlčení	silence
trénovat	train
částice	particles
námaha	exertion
věčně	forever
zadívat	gaze
zklamání	disappointment
strava	diet
herecký	theatrical
zabíjet	killing
řízený	directed
slovník	dictionary
hnízdo	nest
ateliér	studio
referendum	referendum
šperk	jewel
ohledně	regarding
zpravodajství	coverage
srážka	crash
únik	leak
zvolený	elected
chlapík	guy
podniknout	undertake
mravní	moral
USD	USD
Albert	Albert
pouť	pilgrimage
strýček	uncle
vážený	honorable
vyběhnout	run out
lavička	bench
náznak	hint
legislativa	legislation
polibek	kiss
Krist	Krist
demonstrace	demonstration
zastávka	stop
děda	Grandpa
odstup	spacing
sad	park
řvát	scream
Rom	Gypsy
rozhlasový	wireless
ucítit	feel
hrnec	pot
genus	genus
klec	cage
obočí	eyebrows
lupič	robber
stojící	standing
kongres	congress
protáhnout	stretch
formát	format
obojí	both
průvod	parade
tabule	blackboard
sedmdesát	seventy
stíhat	pursue
zajet	run
leč	however
kotel	boiler
mříž	grille
namísto	instead
plést	weave
webový	Web
elegantní	elegant
pestrý	colorful
sevřít	clench
Kladno	Kladno
zoufale	desperately
dílčí	sectional
hněv	anger
odjezd	departure
řez	cut
sir	sir
Ford	Ford
Oldřich	Oldrich
morálka	morality
Řecko	Greece
pódium	podium
semeno	seed
vzdělaný	educated
tý	you
vyrůstat	grow
poděkovat	thank
sklonit	bow
uzavření	closure
vývojový	developmental
zásilka	consignment
melodie	melody
bytí	being
ovzduší	air
skromný	modest
volant	steering wheel
předcházet	prevent
ruch	rush
zátěž	ballast
inspirovat	inspire
půlka	half
shodnout	agree
ústecký	Usti
zakrýt	cover up
přesnost	accuracy
navždy	forever
růže	roses
byznys	business
objednávka	order
opora	support
vada	defect
čepice	hat
impuls	impulse
oltář	altar
horko	hot
dosah	reach
báječný	yummy
Horní	Upper
organizovaný	organized
orientovat	orientate
africký	African
odebrat	take
působící	acting
zábavný	fun
hnout	move
vzrušení	thrill
železo	iron
číšník	waiter
křik	outcry
ublížit	hurt
vana	bathtub
důchodce	pensioner
kanadský	Canadian
kolečko	wheelbarrow
ocenění	appreciation
odvážit	weigh out
namítnout	protest
SNB	SNB
hubený	thin
vlhkost	humidity
převaha	preponderance
vydělávat	earn
přitáhnout	tighten
dělo	cannon
předčasný	premature
otvírat	opening
početný	numerous
putovat	wander
spolkový	federal
zachování	conservation
plánování	planning
osvětlení	lighting
sekunda	second
létat	fly
posloužit	serve
služební	Business
trpělivost	patience
grafický	graphic
federace	federation
vstříc	meet
nadace	foundation
celkově	overall
sluchátko	earphone
dobrovolný	voluntary
Emil	Emil
vykonat	perform
specialista	expert
chodec	walker
ošklivý	ugly
stadium	stage
dynamický	dynamic
úrok	interest
záchvat	seizure
dnešek	today
konzervativní	conservative
vydaný	issued
nebeský	heavenly
přivítat	welcome
splňovat	fulfill
vrata	gate
chytat	catch
obsluha	operation
věřitel	creditor
vyhnat	expel
garáž	garage
smetana	cream
žíla	vein
faktum	FAKTUM
plakát	poster
srovnatelný	comparable
mnich	monk
farář	parson
polštář	cushion
strašlivý	dreadful
horečka	fever
krást	thieve
zoufalství	despair
ČSN	CSN
řadit	shift
slovní	verbal
sídlit	reside
nabývat	acquire
vznášet	float
zkoumání	exploration
ČSSR	CSSR
prestižní	prestigious
prkno	board
přiměřený	adequate
skalní	rock
krám	shop
pronásledovat	chase
hruď	chest
lebka	skull
aliance	alliance
vyznat	profess
zázemí	rear
kamarádka	friend
volno	off
smířit	reconcile
předchůdce	predecessor
přitisknout	impress
zadek	buttocks
tužka	pencil
koncept	draft
kroužek	ring
etický	ethical
Vary	Vary
nesmírně	immensely
ocas	tail
soukromí	privacy
vézt	carry
shrnout	recap
urazit	offend
sklenička	glass
marka	mark
Rumunsko	Romania
spokojit	settle
Teplice	Teplice
třicátý	thirtieth
identita	identity
příjezd	arrival
skvěle	great
lovec	hunter
nitro	heart
oblečený	dressed
pozdrav	greeting
soudruh	comrade
předběžný	preliminary
vyjmout	remove
horizont	horizon
motorový	power
shánět	hunt for
smírně	amicably
pomocný	assistant
týdně	weekly
kladný	positive
rozvojový	developing
vyhledat	search
řádný	proper
přesahovat	exceed
provdat	marry
univerzální	universal
dres	jersey
kompetence	competence
publikovat	publish
palestinský	Palestinian
estetický	esthetic
distribuce	distribution
směšný	ridiculous
zastupovat	represent
náležet	belong
sjezd	downhill
akutní	acute
panel	panel
Opava	Opava
etika	ethics
interní	internal
shodovat	agree
slušet	suit
revoluční	revolutionary
svírat	clutch
uzel	node
fotka	photo
kuře	chicken
Mnichov	Munich
dědictví	heritage
dodržování	compliance
mše	service
to	it
Věra	Vera
systémový	systemic
božský	divine
lidovec	Christian Democrat
milenka	mistress
milovaný	beloved
komunální	communal
psaný	written
MS	MS
vzdálit	leave
zazvonit	ring the bell
kouzelný	Magical
propast	abyss
naložit	load
shromáždit	gather
překvapivě	surprisingly
Frank	Franc
hovězí	beef
transformace	Transformation
zmiňovat	alluding
počáteční	initial
srdeční	heart
komunikovat	communicate
zánik	extinction
zřetelný	clear
odpočinek	relaxation
zaskočit	focus
lídr	leader
hrana	edge
plout	sail
porozumění	understanding
rizikový	hazardous
detektiv	detective
pedagogický	pedagogic
Příbram	Pribram
vyučování	tuition
aplikovat	apply
Turecko	Turkey
absolvent	graduate
farma	farm
šílenství	madness
doktorka	Doctor
gólman	goalie
nebesa	Heavens
pohon	drive
zvyšování	increasing
podnikat	business
marný	futile
dotyčný	in question
ochotně	willingly
design	design
stehno	thigh
odmlčet	pause
KSČM	KSČM
popel	ash
rádium	radium
vídeňský	Viennese
Čapek	Čapek
připojení	connectivity
listí	Leaves
celní	customs
HDP	GDP
počít	conceive
Slovák	Slovak
přibývat	grow
nikam	nowhere
podrobit	undergo
symbolický	symbolic
plus	plus
raketa	rocket
zavraždit	murder
pokrm	dish
Viktor	Viktor
přistát	land
identifikovat	identify
past	trap
posun	shift
automobilka	car factory
chvět	quiver
poskytování	provision
psycholog	psychologist
skupinka	cluster
menšina	minority
opakovaně	repeatedly
přibližovat	draw near
rozkoš	delight
turecký	Turkish
zkušební	probationary
aparát	apparatus
komplikovaný	complicated
splnění	fulfillment
bojovník	fighter
uspokojení	satisfaction
foto	Photo
náruč	armful
zákrok	intervention
komunismus	Communism
trojice	threesome
orientovaný	oriented
administrativní	administrative
klavír	piano
muzika	music
neúspěch	failure
rakev	coffin
racionální	rational
anketa	survey
fungování	functioning
rozpočtový	budgetary
slabost	weakness
zvědavý	curious
interval	interval
otřást	shake
databáze	database
plynový	gas
projíždět	drive through
cílový	target
životnost	service life
upřesnit	specify
vysočina	highlands
fenomén	phenomenon
legendární	legendary
newyorský	New York
potrestat	punish
zavěsit	hang
hřeben	crest
provedený	executed
deficit	deficit
personální	Human Resources
provincie	province
zodpovědnost	responsibility
vyhlídka	outlook
N	N
úkon	act
autorský	author's
každoročně	annually
něžný	affectionate
opakovaný	repeated
sako	jacket
firemní	business
spokojeně	happily
pneumatika	tire
prodloužit	extend
krabička	box
potvrzení	confirmation
zdržet	abstain
Belgie	Belgium
modernizace	modernization
pozdravit	greet
soustředění	concentration
těžba	extraction
stres	stress
dokola	round
lesklý	bright
mise	mission
rozsvítit	switch on
Aleš	Ales
čerpat	draw
kostým	costume
zemědělec	farmer
dobový	period
smůla	bad luck
vytrhnout	rip
korupce	corruption
šťastně	happily
Temelín	Temelin
spolužák	classmate
tahat	pull
nositel	bearer
sedmnáct	seventeen
liberální	liberal
rozejít	break
svatební	wedding
vyhlášení	promulgation
doplněk	supplement
přijíždět	arrive
pětadvacet	Twenty-five
zábradlí	railing
umístěný	situated
kuchyňský	cooking
Boleslav	Boleslav
čistota	cleanliness
terasa	terrace
akademický	academic
organický	organic
vrhat	throw
zralý	mature
mnohokrát	many times
Tommy	Tommy
var	boiling
balkón	balcony
náprava	rectification
logistika	logistics
moudrost	wisdom
mrkev	carrot
sedlo	saddle
unikátní	unique
osvobodit	liberate
císařský	imperial
členství	membership
páska	tape
autorka	authoress
honit	chase
lano	rope
Masarykův	Masarykův
reprezentovat	represent
vdova	widow
zvažovat	weigh
zvon	bell
Ray	Ray
vyčítat	reproach
formulovat	formulate
Ital	Italian
mládenec	youngster
chlad	coldness
jakož	and
nájemné	rent
stvoření	creation
Jugoslávie	Yugoslavia
pivovar	brewery
zánět	inflammation
vlajka	flag
evidence	records
hýbat	stir
věcný	factual
křesťanství	Christianity
romský	Gypsy
záchod	toilet
nervózní	nervous
víčko	cover
Jablonec	Jablonec
zlínský	Zlin
obdiv	admiration
produktivita	productivity
Zuzana	Zuzana
bílkovina	protein
odvážný	courageous
absolutně	absolutely
okénko	window
půvabný	lovely
hotovost	cash
atom	atom
krém	cream
ohlédnout	look back
budování	building
přepadnout	swoop
šeptat	whisper
šňůra	cord
ujít	miss
pokožka	skin
deprese	depression
otrok	slave
zřízení	establishment
vrch	hill
aféra	affair
legální	legal
nevěsta	bride
vystřelit	fire
Los	Moose
rozbor	analysis
příště	next
stádo	herd
stříbro	silver
šíření	spreading
Beneš	Benes
intelektuální	intellectual
show	show
hlavička	header
bakterie	bacteria
citový	emotional
dokončení	completion
zavírat	close
odpočívat	rest
inovace	innovation
kilogram	kilogram
ruční	hand
zaujímat	cover
vzpamatovat	recover
reflex	reflex
zločinec	felon
Julie	Julia
hele	hey
mandát	mandate
vyložit	unload
léčení	treatment
náboj	charge
vzestup	rise
sledovaný	watched
samec	male
zavázat	tie
porozumět	understand
zaměstnávat	employ
Sam	Sam
zapojení	involvement
zpracovávat	handle
barák	barrack
f	F
přípravek	preparation
St	St
inspirace	inspiration
KDU-ČSL	KDU-ČSL
poctivý	honest
pojmenovat	name
rituál	ritual
fasáda	facade
chytnout	catch
rozložit	spread
definitivní	final
otevřeně	openly
spadat	fall
fantastický	fantastic
zdržovat	restrain
dočasný	temporary
promíchat	mix up
zastoupení	representation
aha	I see
Alena	Alena
Dolní	Lower
smíchat	mix
odvětit	rejoin
hit	hit
pasáž	passage
finančně	financially
záhada	mystery
zprvu	initially
Mexiko	Mexico
výcvik	training
vkus	taste
krýt	cover
disponovat	dispose
katedrála	cathedral
maličký	little
ničit	destroying
obětovat	sacrifice
jasno	clear
předpokládaný	supposed
zahrádka	garden
varování	warning
magnetický	magnetic
těhotenství	pregnancy
zelí	cabbage
jinam	elsewhere
porota	jury
zodpovědný	accountable
Street	Street
telekomunikační	Telecommunications
vzorec	formula
genetický	genetic
vyplnit	fill
výtvarník	artist
posypat	sprinkle
poválečný	postwar
sociálně	socially
opak	opposite
pěšky	on foot
stáj	stable
telefonovat	telephone
málokdo	hardly anybody
přechodný	transitory
zdobit	Dress Up
stvořit	create
Angličan	Englishman
socialismus	socialism
komponenta	component
hm	hm
nástupce	successor
posilovat	strengthen
provádění	implementation
předávat	forward
pohotovost	alert
diagnóza	diagnosis
palma	palm
strážce	watchman
nadšený	enthusiastic
střevo	intestine
zavazadlo	luggage
ČNB	CNB
lámat	break
učebnice	textbook
vybavený	equipped
bariéra	barrier
kroutit	writhe
poukazovat	pointing
prima	groovy
zahradní	garden
natáčení	shooting
vesměs	mostly
muzikál	musical
odstín	hue
volání	call
přistupovat	access
uherský	Hungarian
honem	come on
ložisko	bearing
pila	sawmill
jakost	quality
transport	transport
produkovat	produce
užití	use
jmění	fortune
prsa	breast
záhadný	light
bída	terrorist
nádobí	thankful
krátkodobý	export
křivka	written
lít	shield
žánr	papery
mávat	rejoice
pátrání	alternative
řádně	motivation
hlášení	horizon
kosmický	bloody
podřízený	priority
pověřit	purchase
Oskar	poison
sportovec	perspective
vznešený	love
drak	commit
prozatím	Japanese
středověk	focus
Bank	doubt
přehrada	distinguish
jehla	Jihlava
Kamil	provide
stávka	fluid
uvedení	interrogation
rozpoznat	Iraqi
archiv	run over
obtěžovat	sleeve
vzdušný	rice
zamyslet	emotion
pozorovatel	Related
vyhledávat	rely
zvěř	license
kamna	link
obří	shine
hotelový	oxygen
psí	indeed
radostný	treat
vykročit	stand
dobrovolně	meter
nepříliš	cash
míjet	candle
nahlédnout	capital
obsahující	accrue
kytara	import
baron	hug
dlouholetý	lend
med	everyday
momentálně	mounted
posílení	lawn
návod	emerge
cihla	exhibit
pluk	comment
samostatně	medicine
smíšený	audible
kolonie	myth
kořist	News
otisk	stand
robot	clear
shodný	variety
knoflík	distinguish
automat	spine
duel	honest
kvalifikovaný	Share
napjatý	observation
vévoda	rarely
gotický	great
nádor	attack
očistit	immediately
placený	acquire
povrchový	founder
příhoda	story
cvičit	apologize
devadesát	adversary
ozdoba	Henry
pomocník	Carlsbad
svést	after all
uprchlík	operator
obranný	injury
rozvinout	clash
tisíciletí	rough
vesele	as
marketing	violate
pouto	odor
černoch	sexual
naposled	controversial
obytný	village
pomůcka	grasp
ČSOB	add
nevýhoda	Remove
pohovka	devil
břemeno	eighty
trvání	operator
česky	testify
násilný	good
vrazit	era
brigáda	run
katalog	flooding
extraliga	Presentation
rukavice	exhibit
špetka	transfer
vymýšlet	separate
dominantní	vitamin
spjatý	post
popírat	Beit
pravice	Czech
odevzdat	permeate
grafika	prevention
srovnávat	recipe
stanoviště	plaything
výjimečně	service
jednička	led
panství	potato
trubka	sweetheart
uchovat	continue
rovnost	globe
ubytování	brittle
propojení	cloud
Angeles	William
nouze	nervous
vpřed	secrete
pozemní	reach
zlomenina	Christian
Afghánistán	concretely
dutina	jihočeský
financovat	fire
hrdý	treasure
zajatec	overpass
zaměřovat	ground
matčin	ring
příliv	adventure
dělení	pope
Jordan	balanced
ovce	therapy
relativní	Gross
dluhopis	Charles
půle	infer
vlézt	universally
nosný	ideal
prase	Peace
komín	working
milovník	fighting
můstek	civil
odrazit	where are you
lípa	lying
rozhlížet	spectrum
sněhový	recognition
šetření	lack
velvyslanec	energetics
připsat	manipulation
vzdychnout	strike
zápěstí	dialogue
dívčí	Telecom
vyptávat	cautious
výstavní	residual
nalézat	limit
chutnat	use
oblékat	embarrassment
ojedinělý	frame
rozlehlý	play
vyndat	intelligence
nu	Hitler
KSČ	elbow
poučit	respondent
pozvání	listen
sleva	created
nezbytný	be subject to
tloušťka	Sweden
mozkový	original
poklesnout	Christ
vrcholný	attentively
uznávaný	width
pokrývat	bush
tajně	Pole
obchodování	Bratislava
porada	vote
rockový	minimum
skákat	craft
hloupost	leave
pauza	banknote
zasadit	serving
dopřát	well-wisher
huba	educational
námořník	gulf
oslavit	load
uvítat	judge
nářadí	swim
úmrtí	clay
vypnout	barely
antický	vex
kontejner	marriage
koutek	attractive
snižování	housing estate
zrodit	elapse
MF	infrastructure
probírat	Stalin
připomínající	musician
uložený	statistic
lovit	base
ministerský	major
rozpad	applicant
vedro	born
technik	alternative
mezera	completion
nahrávka	CEZ
vyrovnání	normally
Ondřej	protest
krb	smell
Santa	significantly
údiv	sacred
hedvábný	mill
zaručit	rotate
vládce	creature
instalace	baroque
rybář	Lemon
sjet	objection
modul	chain
odpočinout	edited
pečovat	economist
diplomatický	concern
rozesmát	Max
aktivně	assemble
don	backup
nanejvýš	cub
nit	popularity
převézt	settlement
připomínka	autumnal
narušit	judge
sakra	per month
bedna	claim
dobytek	run
metropol	sit down
muzikant	backwards
vnuk	Philip
masa	abduct
ml	patiently
Novotný	include
spálit	English
uspokojit	crash
zařvat	seventieth
hormon	quarter
terorismus	philosopher
pec	bloody likely
rekreační	cook
obsáhnout	Jew
takovýhle	radio
skládka	concealing
stop	recognize
zástup	take down
rozloha	representative
ignorovat	ramp
inspekce	arrive
taxík	experiment
ponořit	fiftieth
přihlížet	railway
Henry	integrated
promítat	tank
Radek	obligatory
Franz	quote
srozumitelný	scandal
kupodivu	mention
načež	turn
náručí	comply
tušení	partly
obrys	for heaven's sake
důstojný	knight
hladit	rise
ulevit	local
konkurent	dual
nastupovat	filling
vrtulník	partition
bible	Vltava
IPB	sweat
StB	divert
zdvihnout	talk over
programový	investigate
předkládat	infliction
rozeznat	pleasantly
vozit	wall
náskok	code
pěna	Romanian
předcházející	van
přiložit	give
spotřební	force
logicky	Thomas
Alexandr	check
obrazový	hit
ředitelství	message
sucho	parking lot
dobrá	nutrition
segment	excuse
stěhovat	flat
montáž	Sofia
vyrobený	cover
ambice	starting point
přitažlivý	eightieth
vrcholek	broth
skrýt	molecule
velkolepý	opposite
ovocný	mailbox
sekce	ca.
čekání	thanks
domovní	risk
leda	pasus
obhájce	nominative
odstoupit	cancer
slušně	gasoline
hlubina	submarine
odraz	Egypt
přesun	walk
žebříček	intensity
obtížně	silence
velení	train
Ena	particles
trosky	exertion
pedagog	forever
přihodit	gaze
zamknout	disappointment
sklenka	diet
tažení	theatrical
donést	killing
export	directed
patřičný	dictionary
věnovaný	nest
pracovna	studio
pružný	referendum
rozbitý	jewel
plavba	regarding
ryzí	coverage
různě	crash
sedlák	leak
závěs	elected
zle	guy
lítost	undertake
obklopit	moral
zeleň	USD
Olga	Albert
popularita	pilgrimage
Železný	uncle
skutek	honorable
souprava	run out
elita	bench
kudy	hint
australský	legislation
nákupní	kiss
průhledný	Krist
vepřový	demonstration
udržení	stop
najmout	Grandpa
baterie	spacing
ovládání	park
kabelka	scream
tip	Gypsy
víceméně	wireless
mocenský	feel
nadávat	pot
ó	genus
překvapivý	cage
výhrada	eyebrows
odvádět	robber
paleta	standing
temnota	congress
tričko	stretch
vypuknout	format
zhroutit	both
erotický	parade
sponzor	blackboard
disk	seventy
šátek	pursue
úvěrový	run
výsledný	however
snít	boiler
výchozí	grille
nežli	instead
provaz	weave
vcelku	Web
lokomotiva	elegant
štědrý	colorful
kombinovaný	clench
laciný	Kladno
prát	desperately
dodržet	sectional
zaměstnat	anger
nakoupit	departure
kompromis	cut
viď	sir
tlačítko	Ford
usnesení	Oldrich
zajímavost	morality
nahrazovat	Greece
stručně	podium
vypustit	seed
čerstvě	educated
rostlinný	you
pojmout	grow
popsaný	thank
umýt	bow
dobrovolník	closure
originál	developmental
zpoždění	consignment
nabrat	melody
selhání	being
vozovka	air
vzbuzovat	modest
olympiáda	steering wheel
částečný	prevent
nadchnout	rush
odolnost	ballast
páteř	inspire
zamilovaný	half
důležitost	agree
ropný	Usti
golf	cover up
nulový	accuracy
spočítat	forever
chutný	roses
moucha	business
smutně	order
ideologie	support
nadřízený	defect
nizozemský	hat
kamión	impulse
příkop	altar
důvěřovat	hot
Ivo	reach
Mikuláš	yummy
ujišťovat	Upper
výstřel	organized
natáčet	orientate
zaměstnanost	African
oběh	take
moč	acting
bouřlivý	fun
City	move
plast	thrill
sonda	iron
zkratka	waiter
prohra	outcry
nádvoří	hurt
zavádět	bathtub
architektonický	pensioner
Kolín	Canadian
svěží	wheelbarrow
soucit	appreciation
vstupenka	weigh out
pěší	protest
přijatý	SNB
zabalit	thin
box	humidity
hráz	preponderance
intelektuál	earn
irský	tighten
nájemník	cannon
pouzdro	premature
Group	opening
partie	numerous
latinský	wander
ukrýt	federal
užitek	conservation
ochránce	planning
vlivný	lighting
Vítkovice	second
držitel	fly
snesitelný	serve
zásuvka	Business
marketingový	patience
kilo	graphic
kontrakt	federation
oloupat	meet
hypotéza	foundation
klika	overall
obzvlášť	earphone
odběr	voluntary
pohřbít	Emil
vařený	perform
Honza	expert
potlačit	walker
filtr	ugly
naplno	stage
policajt	dynamic
rozhodný	interest
zjevný	seizure
pomník	today
prostorový	conservative
graf	issued
Chomutov	heavenly
bezpochyby	welcome
Evropan	fulfill
celosvětový	gate
kyselý	catch
narážet	operation
rejstřík	creditor
kruhový	expel
vyhrožovat	garage
tropický	cream
dominovat	vein
vášnivý	FAKTUM
vyplácet	poster
obžaloba	comparable
Nizozemsko	monk
zájezd	parson
egyptský	cushion
střelba	dreadful
fyzikální	fever
problematický	thieve
prodloužení	despair
kotník	CSN
leasing	shift
ligový	verbal
prozrazovat	reside
úzce	acquire
zhasnout	float
kalendář	exploration
koka	CSSR
středočeský	prestigious
údajný	board
belgický	adequate
spekulace	rock
panenka	shop
úhrada	chase
zastoupit	chest
vojna	skull
audit	alliance
uvolnění	profess
absurdní	rear
ořech	friend
pomyslit	off
přízemí	reconcile
tenis	predecessor
sympatický	impress
záře	buttocks
žloutek	pencil
cyklista	draft
náraz	ring
stoupenec	ethical
extrémní	Vary
majetkový	immensely
nač	tail
děsit	privacy
Markéta	carry
odpadní	recap
bezmála	offend
odporný	glass
spravovat	mark
studijní	Romania
čelist	settle
Jitka	Teplice
darovat	thirtieth
naplňovat	identity
zastavovat	arrival
zezadu	great
obilí	hunter
boční	heart
modelka	dressed
Ukrajina	greeting
obdobně	comrade
Times	preliminary
kopat	remove
naléhat	horizon
politicky	power
právem	hunt for
proslavit	amicably
International	assistant
sdělovat	weekly
škála	positive
zlikvidovat	developing
kádr	search
nacistický	proper
přežití	exceed
přísahat	marry
uvolněný	universal
kdekoliv	jersey
přiznání	competence
pověsit	publish
líčení	Palestinian
omýt	esthetic
sankce	distribution
uvěřitelně	ridiculous
formulace	represent
Tony	belong
objasnit	downhill
fyzicky	acute
poručík	panel
zatracený	Opava
atentát	ethics
koláč	internal
posudek	agree
kupředu	suit
peněženka	revolutionary
plošina	clutch
sebemenší	node
hraniční	photo
naléhavý	chicken
optický	Munich
holub	heritage
profesionál	compliance
DPH	service
obviněný	it
syndrom	Vera
Eduard	systemic
kaše	divine
očividně	Christian Democrat
stručný	mistress
dopravit	beloved
přestupek	communal
asijský	written
Jirka	MS
vypravovat	leave
čtvereční	ring the bell
samozřejmý	Magical
funkcionář	abyss
podávání	load
akorát	gather
dokládat	surprisingly
řídicí	Franc
vytahovat	beef
Štěpán	Transformation
chronický	alluding
figura	initial
pomyšlení	heart
soustřeďovat	communicate
US	extinction
dokonalost	clear
připadnout	relaxation
sběr	focus
video	leader
zmatený	edge
centr	sail
islámský	understanding
končetina	hazardous
palba	detective
proužek	pedagogic
zatáhnout	Pribram
dvojče	tuition
legislativní	apply
přepravní	Turkey
poselství	graduate
vydechnout	farm
docent	madness
chaos	Doctor
oxid	goalie
pyšný	Heavens
turné	drive
žadatel	increasing
bronzový	business
nováček	futile
vynechat	in question
hradit	willingly
slovanský	design
vyřadit	thigh
pilíř	pause
pominout	KSČM
kupříkladu	ash
odhodit	radium
zámecký	Viennese
svléknout	Čapek
vypovědět	connectivity
sebevědomí	Leaves
Edward	customs
kabel	GDP
povolat	conceive
schovávat	Slovak
zabezpečit	grow
magický	nowhere
skupinový	undergo
zkontrolovat	symbolic
důvěrný	plus
utratit	rocket
hrnek	murder
posouzení	dish
praštit	Viktor
závidět	land
abstraktní	identify
analyzovat	trap
hrobka	shift
lhostejný	car factory
lodní	quiver
výstupní	provision
kompozice	psychologist
prachy	cluster
spolehlivost	minority
taktika	repeatedly
naivní	draw near
školský	delight
agresivní	Turkish
ocet	probationary
zadarmo	apparatus
čtyřkoalice	complicated
Mark	fulfillment
útočit	fighter
zaváhat	satisfaction
čokoláda	Photo
dvojitý	armful
hádka	intervention
nosič	Communism
oddělený	threesome
výbava	oriented
nastavit	administrative
primitivní	piano
Simon	music
trik	failure
nájem	coffin
popřít	rational
reprezentační	survey
zastavení	functioning
car	budgetary
nastávat	weakness
sázet	curious
distribuční	interval
ohlas	shake
osvobození	database
vyšplhat	gas
básnický	drive through
děsivý	target
kancléř	service life
povolený	specify
vyplývající	highlands
guvernér	phenomenon
pěstování	legendary
shledat	New York
stavení	punish
šlechtic	hang
výzdoba	crest
pokrytý	executed
studentský	deficit
udávat	Human Resources
rozkládat	province
důkladný	responsibility
Jean	outlook
odlišovat	N
odpolední	act
protiklad	author's
Hradec	annually
chlápek	affectionate
ohrožený	repeated
prohodit	jacket
zanedlouho	business
ZOO	happily
dort	tire
klima	extend
brod	box
posila	confirmation
slepice	abstain
slon	Belgium
pojistný	modernization
samice	greet
sochař	concentration
X	extraction
děcko	stress
summit	round
absence	bright
namalovat	mission
sourozenec	switch on
rozmezí	Ales
němý	draw
titulek	costume
pobřežní	farmer
potřít	period
zaručovat	bad luck
Turek	rip
šunka	corruption
Libor	happily
di	Temelin
diplomat	classmate
plastový	pull
převzetí	bearer
samospráva	seventeen
Černý	liberal
předešlý	break
et	wedding
Chicago	promulgation
chudoba	supplement
Petra	arrive
rozmanitý	Twenty-five
řasa	railing
elektronika	situated
květináč	cooking
polsko	Boleslav
dalekohled	cleanliness
datový	terrace
rezervace	academic
vyčerpat	organic
zemřelý	throw
hlasitý	mature
incident	many times
manažerský	Tommy
trhlina	boiling
poločas	balcony
dozor	rectification
inzerát	logistics
slanina	wisdom
vybudování	carrot
záměrně	saddle
instrukce	unique
rozvést	liberate
terč	imperial
úmluva	membership
ekonomicky	tape
vynález	authoress
zaniknout	chase
zbláznit	rope
cestování	Masarykův
čerpadlo	represent
virtuální	widow
rozhraní	weigh
skříňka	bell
kostra	Ray
závodník	reproach
speciálně	formulate
tíha	Italian
výchovný	youngster
nadměrný	coldness
připravovaný	and
trapný	rent
koza	creation
zničený	Yugoslavia
filozofický	brewery
sloupek	inflammation
ledvina	flag
protější	records
úžas	stir
dodatečný	factual
konání	Christianity
málokdy	Gypsy
anonymní	toilet
bláznivý	nervous
chválit	cover
vycházející	Jablonec
zobrazení	Zlin
Marta	admiration
ochota	productivity
zastihnout	Zuzana
portál	protein
pozvednout	courageous
stíhání	absolutely
tenisový	window
identifikace	lovely
krajní	cash
uprchnout	atom
zadat	cream
pravicový	look back
přízeň	building
subjektivní	swoop
triumf	whisper
kolikrát	cord
bláto	miss
napsaný	skin
zvědavost	depression
CD	slave
omítka	establishment
pohladit	hill
sud	affair
zapadnout	legal
Jeruzalém	bride
poutník	fire
zaznamenávat	Moose
blížící	analysis
favorit	next
zvonit	herd
Bernstein	silver
Einstein	spreading
jedenáctý	Benes
kalifornie	intellectual
panovník	show
repertoár	header
vznikající	bacteria
odborový	emotional
přistihnout	completion
statečný	close
unikat	rest
přerušení	innovation
spoluhráč	kilogram
vzhlédnout	hand
knižní	cover
bylina	recover
věkový	reflex
golfový	felon
pronájem	Julia
schválení	hey
Kuba	mandate
univerzitní	unload
zazpívat	treatment
povšimnout	charge
předpověď	rise
žhavý	watched
dozorčí	male
tudy	tie
zázračný	understand
dobýt	employ
kulička	Sam
nedůvěra	involvement
oč	handle
zobrazit	barrack
sympatie	F
trčet	preparation
vizuální	St
prognóza	inspiration
Vsetín	KDU-ČSL
hvězdný	honest
prospěšný	name
ostrůvek	ritual
seržant	facade
whisky	catch
dýchací	spread
formule	final
krizový	openly
nákladný	fall
vybuchnout	fantastic
ČSR	restrain
Hollywood	temporary
sada	mix up
uložení	representation
zlomek	I see
zúčastněný	Alena
Dánsko	Lower
portfolio	mix
Jágr	rejoin
pitomý	hit
laboratorní	passage
podržet	financially
vo	mystery
přikázat	initially
přivádět	Mexico
odolat	training
přesáhnout	taste
renezanční	cover
kreslit	dispose
oříšek	cathedral
položený	little
velitelství	destroying
zastánce	sacrifice
dlužník	clear
stonek	supposed
tucet	garden
vkládat	warning
hrot	magnetic
středně	pregnancy
tranzistor	cabbage
Al	elsewhere
pozůstatek	jury
probíhající	accountable
výjev	Street
fotoaparát	Telecommunications
Jacek	formula
myšlenkový	genetic
nominace	fill
opice	artist
pohyblivý	sprinkle
převládat	postwar
součástka	socially
záložník	opposite
akční	on foot
trpělivý	stable
vléci	telephone
zavedený	hardly anybody
odhodlat	transitory
odtáhnout	Dress Up
přípravný	create
zapnout	Englishman
plastika	socialism
spaní	component
materiální	hm
propagace	successor
lyžařský	strengthen
keramika	implementation
pohoří	forward
přátelsky	alert
registrace	diagnosis
věčnost	palm
dým	watchman
namířit	enthusiastic
zahnat	intestine
hygienický	luggage
pohodlně	CNB
tiskárna	break
odtamtud	textbook
potrubí	equipped
škodlivý	barrier
dimenze	writhe
Patrick	pointing
tolerance	groovy
místy	garden
snížený	shooting
pohromadě	mostly
zvonek	musical
aktivum	hue
odstartovat	call
vyzvednout	access
Atény	Hungarian
reportér	come on
splátka	bearing
stavebnictví	sawmill
zaslat	quality
kapesník	transport
příšerný	produce
sekretářka	use
sepsat	fortune
útes	breast
vyděsit	
zatáčka	turn
akceptovat	accept
rozpustit	dissolve
strkat	push
vědomost	knowledge
fajn	okay
probouzet	wake
památník	memorial
vyznání	confession
zpod	from beneath
octnout	find oneself
odběratel	subscriber
pobývat	stay
pohřební	funereal
oživení	revival
pýcha	pride
dekret	decree
externí	external
vídat	seeing
vydavatel	publisher
zlepšovat	improving
hořící	burning
zapůsobit	impress
Open	Open
ozvěna	echo
rozvinutý	developed
zaplavit	flood
prozkoumat	explore
rekordní	record
řízek	steak
teze	thesis
vykázat	expel
nazývaný	called
Portugalsko	Portugal
ušlechtilý	noble
Ben	Ben
upoutat	captivate
zaplnit	fill
tabák	tobacco
zápach	odor
hradiště	Strongholds
kostička	Bone
potichu	quietly
vyloučení	exclusion
zakázaný	prohibited
it	it
buben	drum
Korea	Korea
Mooshabrová	Mooshabrová
šatna	cloakroom
samozřejmost	obviousness
úkryt	shelter
maličkost	trifle
placení	payment
kriminalista	criminologist
atomový	atomic
rolník	farmer
vmíchat	mix in
dvojnásobný	double
míle	mile
Alice	Alice
granát	grenade
nafta	oil
živel	element
celostátní	nationwide
cenit	value
nabízený	offered
napravit	remedy
prvotní	prime
delegace	delegation
angažovat	engage
shodit	throw
bohatě	richly
krysa	rat
lekce	lessons
Řek	Greek
námořnictvo	Navy
označený	marked
infarkt	heart attack
moderátor	moderator
nuda	boredom
přidělit	allocate
trup	hull
vyzývat	urge
zkáza	destruction
Jack	Jack
náklaďák	truck
pánbůh	God
týdeník	weekly
hanba	shame
každopádně	In any event,
zhluboka	deep
vzdávat	give up
FMV	FMV
přestavba	reconstruction
směna	shift
umožňující	enabling
verdikt	verdict
přilákat	Attract
čištění	cleaning
jedovatý	toxic
Louis	Louis
Republika	Republic
finský	Finnish
výslovně	expressly
důstojnost	dignity
dvířka	door
přehlédnout	overlook
rock	rock
vysokoškolský	academic
operovat	operate
porost	growth
sušený	dried
Dagmar	Dagmar
der	der
image	image
naživu	alive
rozlišení	distinction
větrný	windy
Benátky	Venice
pouliční	street
Tereza	Tereza
valit	roll
vypořádat	deal
amatérský	amateurish
Cheb	Cheb
pojistka	insurance
stahovat	download
válet	lol
přeměna	conversion
otřes	shock
formulář	form
kriminalita	criminality
vědění	knowledge
věrnost	faithfulness
vráska	wrinkle
dálkový	remote
Indián	Indian
lucerna	lantern
půvab	gracefulness
zapomenutý	forgotten
bydliště	residence
odchylka	deviation
závada	fault
bunda	jacket
nucený	compulsory
olivový	olive
prodavač	salesman
léčebný	therapeutic
levice	left
obstát	hold up
odolný	resistant
shora	above
výčitka	reproach
zabírat	occupy
zvenčí	from without
dánský	Danish
těhotný	pregnant
mávnout	wave
šle	suspenders
zhodnotit	valorize
doložit	submit
ordinace	surgery
plechovka	tin
propuštění	release
fólie	foil
Lenka	Lenka
vyrážet	sprout
bankovnictví	banking
omluva	apology
předsíň	hall
syrový	raw
šíp	arrow
teoreticky	in theory
záporný	negative
mléčný	dairy
Cup	Cup
časný	early
obsazení	cast
pustý	desolate
Bob	Bean
nudit	bore
rozdávat	give out
konstrukční	structural
příznačný	symptomatic
rozdělovat	dole out
vytápění	Heating
odletět	fly out
koaliční	Coalition
podívaná	sight
rybí	fish
sortiment	assortment
ledovec	glacier
Madrid	Madrid
otázat	inquire
operní	opera
potřetí	third
sloužící	serving
zachycovat	Capturing
housle	violin
nejenže	Not only
laskavě	kindly
povzdechnout	Sigh
převažovat	outbalance
velet	command
zvládat	cope
frank	franc
naplnění	fulfillment
rovnat	match
školka	kindergarten
zobrazovat	show
zpomalit	slow down
jáma	pit
Klára	Clare
průchod	passage
balvan	boulder
německy	German
sprcha	shower
vstupné	admission
zamumlat	mutter
dlužit	owe
interakce	interaction
operativní	operative
přiletět	come in
instalovat	install
podřídit	subordinate
upustit	waived
obklopovat	surrounding
Putin	Putin
všelijaký	shady
dokončený	completed
Chrudim	Chrudim
válec	cylinder
C	C
obhajoba	defense
řídký	thin
včerejšek	yesterday
odstraňovat	remove
pohonný	driving
důsledně	consistently
přikrýt	cover
přivolat	call
Žižkov	Zizkov
oprávnění	authorization
zemina	soil
zemní	terrestrial
kvést	flower
rybářský	Fisheries
panika	panic
potýkat	contend
proudit	flow
trestat	punish
nátěr	coating
šofér	chauffeur
rodák	native
vybojovat	to fight
doprovodit	escort
páteční	Friday
Maria	Maria
propojit	link
šero	dimness
úkor	expense
paradoxně	Paradoxically,
použitelný	applicable
uvolňovat	release
překvapeně	surprise
zesilovač	amplifier
ptačí	can
tygr	tiger
holding	Holding
křeč	cramp
kW	kW
postranní	side
světský	secular
holandský	Dutch
výdělek	earnings
vyskytnout	Occur
zemětřesení	earthquake
autobusový	bus
vynikat	excel
zapadat	go down
dynamika	dynamics
hořký	bitter
chov	breeding
lesknout	glisten
střídavě	alternately
zářivý	radiant
držení	holding
obzvláště	especially
harmonie	harmony
lyže	skis
nadcházející	coming
říkávat	říkávat
Sára	Sarah
škodit	harm
Mahler	Mahler
sekundární	secondary
story	story
tzn	ie
zvážit	consider
děvčátko	girl
exponát	exhibit
najíst	eat
argentinský	Argentine
dopravce	carrier
interpretovat	interpret
kombinovat	combine
Larch	Larch
pronikavý	shrill
přebírat	take over
přesvědčovat	persuading
realistický	realistic
srst	fur
citlivost	sensitivity
krajan	homeboy
Brown	Brown
ironie	irony
beseda	Beseda
fyzika	physics
zajisté	surely
četba	reading
přednosta	Head
dieta	diet
DNA	DNA
nadechnout	breathe
stýkat	consort
výplata	paycheck
brzda	brake
veranda	veranda
zamítnout	reject
aneb	or
mocnost	power
nota	note
obdoba	analogy
přehledný	synoptic
historicky	historically
matematika	mathematics
próza	prose
učební	learning
onemocnět	sicken
vzejít	come
liška	fox
odhalení	revelation
resort	department
startovat	take off
zkrátit	shorten
soumrak	twilight
školení	Training
dočasně	temporarily
fotografický	photographic
ochránit	protect
útěcha	consolation
býk	bull
Nathan	Nathan
nudný	boring
strouhaný	grated
šek	check
hustota	density
ilustrace	illustration
mistrovský	masterful
vystudovat	graduate
zachovávat	keep
lesk	sheen
zrada	betrayal
exotický	exotic
řítit	tear
udržitelný	Sustainable
živočišný	animal
mlít	grind
soudobý	contemporary
zavádění	implementation
obsažený	contained
Saddám	Saddam
slaný	briny
bahno	mud
Baník	Miner
Oscar	Oscar
rozpálený	hot
zakoupit	purchase
odjakživa	always
počty	figures
Reuter	Reuter
upřeně	fixedly
hrst	handful
kolekce	collection
šikovný	handy
vychovávat	educate
povstání	insurrection
prchat	fleeing
Vilém	William
kryt	housing
opakování	repetition
rubrika	section
Stephanie	Stephanie
vpředu	ahead
zavinit	cause
Kristův	Christ
kuchař	cook
uhradit	reimburse
naplněný	replete
občanství	citizenship
spojka	clutch
vyhlížet	watch for
žert	prank
doprovodný	Accompanying
poručit	command
příslušnost	affiliation
reportáž	reportage
rozpadnout	break up
textový	text
rabín	rabbi
vodopád	waterfall
vymezení	demarcation
kontaktní	contact
ozdobit	decorate
pochvalovat	Pochvalov
příjemce	recipient
stíhačka	fighter
šokovat	shock
vyplynout	result
kouření	smoking
penzijní	Retirement
selhat	fail
tučný	bold
ucházet	bid
Norsko	Norway
okurka	cucumber
plavidlo	vessel
zamýšlet	think
pochválit	commended
žízeň	thirst
pěšina	footpath
smyslný	sensual
žár	blaze
oční	eye
osvědčit	witness
prožitek	experience
technicky	Technically
zdanění	taxation
muslim	Muslim
prospět	benefit
sádlo	lard
sousedství	neighborhood
ženatý	married
angažmá	contract
dotáhnout	tighten
torpédoborec	destroyer
vyjednávání	negotiation
čarodějnice	witch
Číňan	Chinese
srbský	Serbian
dožít	live
pojistné	premium
prázdnota	void
zblízka	close up
prověřit	check
rasa	race
ustupovat	ebb
vymezit	define
formálně	formally
partnerství	partnership
prosba	plea
přirozenost	nature
pud	instinct
strojírenský	Engineering
vážnost	seriousness
ikona	icon
music	Music
vznést	raise
charta	charter
katedra	department
odhalovat	revealing
osvětlený	lit.
předměstí	suburb
varhany	organ
levicový	leftist
naplánovat	schedule
katolík	Catholic
penze	pension
podmíněný	conditioned
těžit	profit
Bohumil	Bohumil
tlouci	beat
totožnost	identity
zakazovat	prohibit
zevnitř	from the inside
odsouzený	convicted
pavouk	spider
dohlížet	supervise
hlupák	fool
keramický	ceramic
redukce	reduction
bezmocný	helpless
čekaně	waiting
motocykl	motorcycle
odeslat	send
Soňa	Sona
psychiatr	psychiatrist
mrknout	nictate
obcházet	circumvent
směřující	pointing
zjištěný	detected
čistit	clean
napříč	across
porovnat	compare
soutěžní	Competition
výtisk	copy
kulka	bullet
spoření	saving
stárnutí	aging
zanedbatelný	negligible
des	des
podivně	peculiarly
pohybový	motional
předvídat	anticipate
přidaný	added
vniknout	penetrate
záblesk	gleam
zařazení	inclusion
epidemie	epidemic
přednášet	lecture
supermarket	supermarket
vědomě	consciously
záhon	flowerbed
zřítit	crash
j	j
mikrofon	microphone
mladistvý	youthful
vylíčit	describe
zajíc	hare
blbý	stupid
pevnina	mainland
devatenáctý	nineteenth
háček	hook
hlediště	auditorium
háj	grove
intimní	intimate
ručník	towel
trhat	pluck
účetnictví	bookkeeping
elektron	electron
kupní	purchasing
motivovat	motivate
odmítnutí	rejection
pláň	wold
pokušení	temptation
police	shelf
záliba	predilection
hradecký	Hradec
korespondence	correspondence
poradenský	advisory
solidní	solid
vyvolaný	developed
Bagdád	Baghdad
bratranec	cousin
stráň	hillside
strukturální	structural
vaření	cooking
vymezený	circumscribed
balení	Package
dotek	touch
pozemský	earthly
prorok	prophet
komplikovat	complicate
potřást	shake
Ellen	Ellen
gumový	rubber
sbohem	goodbye
sestoupit	descend
upřít	fix
kolář	wheeler
povařit	simmer
známost	acquaintance
křížový	cross
límec	collar
vdát	married
etnický	ethnic
fialový	violet
okupace	occupation
opravovat	repair
plachta	sail
Prostějov	Prostejov
Sokol	Falcon
Varšava	Warsaw
dirigent	conductor
lóže	lodge
odporovat	resist
výstaviště	exhibition grounds
opepřit	pepper
přijímací	Drawing
sluníčko	sun
tisícovka	thousand
buněčný	cellular
dom	house
ňadra	bosom
nastavení	adjustment
p	p
pečivo	pastry
namítat	object
oznamovat	report
ujet	cover
obchodovat	deal
panelový	panel
unavit	weary
veličina	quantity
perla	pearl
aut	Rental
filosofický	Philosophical
hladový	hungry
natož	let alone
Zdena	Zdena
efektivnost	efficiency
jazz	jazz
magazín	magazine
stanout	stand
Juan	Yuan
pavilon	Pavilion
propadat	fall
spatřovat	seen
obývací	living
přílišný	excessive
rosa	dew
šlechta	nobility
zač	You're welcome
závisle	dependently
nečekaný	unexpected
přesvědčivý	convincing
zahledět	stare
stará	old
národnost	nationality
plno	lot
pomsta	revenge
poukázat	refer
ziskový	Profitable
aktivista	activist
domorodec	native
husa	goose
nasekaný	chopped
pololetí	semester
drtivý	crushing
loupež	robbery
studentka	student
změřit	measure
chirurgický	surgical
pokročilý	advanced
restrukturalizace	restructuring
dočíst	finish
kanalizace	canalization
nacista	Nazi
sešit	notebook
hornina	rock
membrána	membrane
zásobník	magazine
kapalina	fluid
němčina	German
pronajmout	rent
strmý	steep
zkazit	spoil
míchat	stir
pocta	tribute
svetr	jumper
školák	schoolboy
bona	nursemaid
ministryně	Secretary
Nedvěd	Nedvěd
obr	giant
registrovat	register
sloupec	column
paradox	paradox
čtyřikrát	four
hladce	smoothly
plechový	tinny
dvouletý	biennial
regál	bookshelf
soužití	cohabitation
zaklepat	knock
optimismus	optimism
play	Play
Bach	Bach
bouda	booth
uskutečňovat	carry
dopadat	turn out
hn	hn
lovecký	hunting
centrála	headquarters
fiskální	fiscal
obrácený	reverse
odkládat	procrastinate
odstěhovat	move
přehnaný	exaggerated
trhnout	jerk
usnadnit	facilitate
včela	bee
Anderson	Anderson
BBC	BBC
křižník	cruiser
dýchání	breathing
leták	flyer
motýl	butterfly
přikládat	attachments
vyrovnávat	leveling
Brazílie	Brazil
definovaný	defined
dvorek	yard
Oliver	Oliver
podivit	wonder
rum	rum
semifinále	semifinal
Ivana	Ivana
profesní	Professional
přesvědčený	convinced
vyspat	sleep
azyl	asylum
pospíchat	rush
renezance	Renaissance
utrhnout	pluck
vypálit	burn
čelní	frontal
důvěrně	familiarly
globalizace	globalization
oceňovat	appreciate
sklouznout	slither
fungující	functional
kurva	whore
občasný	occasional
časově	time
deka	blanket
koňský	equine
kupec	buyer
místostarosta	Deputy Mayor
oddaný	dedicated
oslabit	weaken
otřít	wipe
pohlížet	seen
prostranství	space
revolver	revolver
zamávat	wave
bolestný	painful
poloostrov	peninsula
ES	ES
odsud	from here
předvolební	election
ubírat	subtract
zamyšleně	pensively
indiánský	Indian
mastný	greasy
růž	rouge
upevnit	consolidate
vrozený	congenital
gravitační	Gravitational
kasárna	Barracks
obléknout	clothe
písemně	writing
Wells	Wells
chřipka	flu
nájemce	tenant
narůstat	build
pohodlí	comfort
zoologický	zoological
doporučený	registered
poplatník	taxpayer
regulační	Regulatory
směnka	bill
totální	total
armádní	army
bušit	throb
MMF	IMF
koupat	bathe
oživit	revive
vězeňský	prison
zajetí	captivity
zdivo	brickwork
huť	huť
petrželka	parsley
plicní	pulmonary
povodňový	flood
atrakce	attraction
dárce	donor
element	element
nedaleko	near
terminál	terminal
žebřík	ladder
kolegyně	colleague
tečka	dot
odradit	discourage
václavský	Wenceslaus
vyděšený	frightened
nátlak	compulsion
ohnivý	fiery
oranžový	orange
zakrývat	hide
zamíchat	stir
zásobování	supply
utopit	drown
hlásat	proclaim
Stanley	Stanley
krčit	cringe
oddělovat	separate
úpadek	bankruptcy
vzdalovat	recede
honorář	fee
odtrhnout	tear off
Dana	Dana
důsledný	consistent
Microsoft	Microsoft
odpadky	trash
synek	synek
zdědit	inherit
kafe	coffee
nadělat	wreak
vjet	enter
získávání	acquisition
naříkat	wail
šéfredaktor	editor in chief
zaměstnaný	employed
hollywoodský	Hollywood
SSSR	USSR
čočka	lens
plastický	plastic
uchýlit	resort
výlučně	exclusively
dosažený	achieved
hrozen	Grape
nemocniční	hospital
Pohár	Cup
hostit	entertain
masivní	massive
prokazovat	show
vyhrknout	blurt
krmit	feed
petice	petition
preventivní	preventive
spojenecký	Allied
neutrální	neutral
odbýt	put off
poprosit	ask
sázka	bet
bramborový	potato
Cadfael	Cadfael
dlažba	paving
jízdenka	ticket
Palestinec	Palestinian
pasažér	passenger
sáček	bag
záminka	excuse
konvenční	conventional
odkázat	refer
telegram	telegram
trápení	vexation
živnostenský	Licensing
experimentální	experimental
kéž	I wish
raněný	Hurt
sedící	sitting
zakončit	conclude
argentina	argentina
čirý	limpid
fotografovat	photograph
mystický	mystical
slupka	peel
smyslový	sensory
tržiště	market
třídní	class
argumentovat	argue
předepsaný	prescribed
stavitel	builder
Hašek	Hasek
invaze	invasion
jihovýchodní	southeast
potkávat	meet
prodělat	go through
vlídný	benign
lineární	linear
loďstvo	fleet
rozčilovat	exasperate
zlomený	broken
činný	active
pohádkový	fairytale
uspořádaný	orderly
ISO	ISO
pasivní	passive
Vojtěch	Vojtech
divoce	wildly
chirurg	surgeon
obráběcí	machining
protějšek	counterpart
nakládat	deal
nesmírný	immeasurable
příručka	handbook
démon	demon
trpaslík	dwarf
viník	culprit
dceřiný	subsidiary
prales	virgin forest
zpravodaj	reporter
malta	mortar
Mercedes	Mercedes
slavnostně	solemnly
sluch	hearing
džungle	jungle
jelen	deer
Písek	Sand
přípustný	permissible
znečištění	pollution
kroužit	circle
objímat	hugging
Otto	Otto
povědomí	awareness
eso	ace
obydlí	dwelling
poloviční	half
status	status
uchovávat	store
zmírnit	relieve
Děčín	Decin
klasifikace	classification
vyhrávat	winning
zavazovat	bind
Agnes	Agnes
hrnout	pour
přezdívka	nickname
ctnost	virtue
leccos	many things
vyhlášený	renowned
členka	Member
nakolik	how much
pokorný	lowly
popíjet	sup
výčet	enumeration
chvála	praise
košík	basket
odsunout	evacuate
osudný	fatal
pozvolna	slowly
turistika	tourism
bohyně	goddess
vyčistit	clean
hrudník	chest
nadšeně	enthusiastically
něžně	tenderly
hodnotový	value
nasvědčovat	suggest
opatrnost	caution
projednat	discuss
přilehlý	adjacent
spouštět	run
Znojmo	Znojmo
zvláštnost	specialty
hostinec	inn
chápání	understanding
kočár	carriage
muslimský	Muslim
uklidit	clean up
chybný	wrong
nápor	onslaught
vlastnický	possessive
kupující	buyer
zvyklost	convention
lože	bed
předloha	pattern
přijímání	communion
jezírko	lagoon
miss	miss
prázdno	void
svádět	tempt
důrazně	emphatically
obhajovat	advocate
parfém	perfume
pečlivý	careful
řemeslník	craftsman
zmoci	emerge again
dovolený	allowable
nakreslit	draw
šlapat	tread
tlakový	Pressure
doutník	cigar
loučit	say goodbye
síťový	Network
trvající	ongoing
devatenáct	nineteen
donedávna	Until recently,
koncertní	concert
zaplacení	repayment
plachý	shy
venkovní	outdoor
cholesterol	Cholesterol
kravata	tie
procedura	procedure
veterán	veteran
celník	customs officer
jugoslávský	Yugoslav
sled	sequence
Smith	Smith
zjevení	revelation
nikterak	no way
stodola	barn
stroužek	clove
čtyřiadvacet	twenty-four
Edita	Edita
koordinace	coordination
seno	hay
sexualita	sexuality
bezplatný	free
míchání	agitation
šplhat	climb
holocaust	Holocaust
kázání	sermon
pověstný	notorious
zatvářit	look
zneužívat	abuse
adekvátní	suitable
figurovat	figure
junior	junior
Leo	Leo
odnášet	carry away
tvořený	formed
závodní	competitive
detailní	detailed
Husajn	Hussein
ponětí	idea
rádiový	radio
transplantace	transplantation
zdvořilý	polite
odněkud	from somewhere
příchozí	arrival
vyhradit	reserve
zlom	fault
zrcátko	mirror
devizový	Foreign Exchange
Elisabeth	Elisabeth
knihkupectví	bookstore
ožít	come back to life
přežívat	surviving
ucelený	integrated
víko	cover
dlužný	due
dráždit	tease
Jondalar	Jondalar
konzultace	consultation
líc	obverse
obuv	shoes
řezný	cutting
sekta	sect
totožný	identical
Irena	Irena
Karviná	Karvina
prodávající	seller
Blair	Blair
Blšany	Blšany
certifikát	certificate
empirický	empirical
léčebna	Treatment Center
lednička	refrigerator
zpochybnit	to challenge
asistence	assistance
Kamila	Kamila
lak	varnish
osmnáctý	eighteenth
rázně	sharply
banda	gang
desetina	tenth
Nick	Nick
podlít	basted
úbytek	decrease
většinový	Majority
op	op
Petra	Petra
pochybný	doubtful
prokurátor	prosecutor
recepce	reception
úsporný	saving
váhání	hesitation
baba	hag
diskriminace	discrimination
José	José
pohlednice	postcards
porušovat	violate
VI	VI
vrcholový	top
vychladnout	cool
vyšetřit	examine
Zuzi	Zuzi
dříví	wood
epocha	epoch
kuchařka	cookbook
odbyt	sales
pitva	autopsy
prezidentův	president
ubytovna	hostel
zhoubný	malignant
pověřený	authorized
souvislý	coherent
kožní	cutaneous
ss	ss
starověký	ancient
uvařený	boiled
vyústit	result
černobílý	black and white
Havlíčkův	Havlíčkův
hrozivý	threatening
ohlížet	looking back
pojistit	insure
porcelán	porcelain
ventil	valve
zmiňovaný	mentioned
Abrahám	Abraham
cpát	Ram
homosexuální	gay
Jenny	Jenny
kancelářský	office
konzervatoř	conservatory
nepokoj	restlessness
padlý	fallen
rezoluce	resolution
ukrývat	shelter
živina	nutritive
nůžky	scissors
zneužít	misuse
ničivý	destructive
penzión	guesthouse
relace	session
testovat	test
bezvědomí	unconsciousness
del	del
fráze	phrases
kázat	preach
kráska	beauty
ohrada	fence
optimistický	optimistic
Pega	Pega
prut	rod
zasvěcený	sacred
zdůvodnit	justify
betlém	crib
lákavý	seductive
lékařka	doctor
nářek	lament
poznávací	cognitive
rozpačitě	sheepishly
sestupovat	go down
so	with
AIDS	AIDS
hradní	castle
oblíbit	take to
řádit	rage
úsvit	dawn
jídelní	dining
prvoligový	first league
zmítat	convulse
emocionální	Emotional
hospodář	husbandman
nadání	talent
ochutnat	sample
šampión	champion
vnitrozemí	inland
zhoršovat	worsen
způsobilost	qualification
odveta	reprisal
oslabení	weakening
uvěznit	jail
vztáhnout	relate
dospívající	teenage
dotyk	touch
podzemí	underground
skladiště	storehouse
střídání	alternation
uzdravit	cure
zavítat	visit
střih	cut
břišní	abdominal
páchnout	stink
pozemkový	landed
požehnání	blessing
problémový	offending
úplatek	bribe
budka	booth
idiot	idiot
něha	tenderness
oprávněně	justly
provázek	string
přednést	perform
roucho	robe
slina	spittle
metodický	methodical
motorista	motorist
redukovat	reduce
deformace	deformation
evidentně	obviously
Chorvatsko	Croatia
koupaliště	swimming pool
Krumlov	Krumlov
mlátit	thresh
opomenout	omit
vynášet	exalt
zuřivě	ferociously
agresivita	aggressiveness
laserový	Laser
viceprezident	vice-president
vystavět	erect
zápal	inflammation
argumentace	argumentation
čí	whose
Flick	Flick
jihovýchod	southeast
obnovitelný	renewable
opřený	leaning
týdenní	weekly
institucionální	Institutional
Jiřina	Dahlia
podílový	podílový
renomovaný	renowned
Florencie	Florence
laik	layman
Sobotka	Sobotka
vyčlenit	earmark
vykřikovat	shout
molo	pier
sousto	morsel
zájmový	interest
ego	ego
Jimmy	Jimmy
opilec	drunk
přemítat	ruminate
Sabina	Sabina
tribunál	tribunal
vak	bag
znemožnit	make impossible
aukce	auction
Dostál	Dostal
kouzelník	magician
misionář	missionary
nervozita	nervousness
preferovat	favor
přehánět	exaggerate
puma	puma
punčocha	stocking
regulovat	regulate
Schröder	Schröder
vyráběný	produced
zaplést	embroil
hlouček	knot
chlup	hair
patron	patron
televizor	television set
esej	essay
lyžování	skiing
mostecký	Most,
propagovat	propagate
stárnout	age
bizarní	bizarre
Luděk	Ludek
psychika	psyche
vrcholit	culminate
zabalený	packed
klávesa	key
otevřenost	openness
poskakovat	flounce
převrat	putsch
citát	quote
četa	squad
chrámový	Temple
Laura	Laura
mravenec	ant
nastartovat	start
pětkrát	five times
přísaha	oath
půjčovat	lend
sociologie	sociology
újma	harm
uzávěr	cap
rvačka	melee
nabírat	scoop
očko	eyelet
počest	honor
průjezd	passage
teror	terror
traktor	tractor
Dušan	Dusan
chodívat	chodívat
osušit	dry
strouhanka	breadcrumbs
variace	variations
imunita	immunity
leknout	frightened
strávený	Spent
udělovat	grant
aréna	arena
ctít	venerate
prestiž	prestige
vzrušovat	excite
zhotovit	make
Mareš	Mares
milá	dear
nadějný	hopeful
řadový	serial
sevřený	pent
účinkovat	have an effect
vinohrad	vineyard
zrno	grain
překážet	interfere
příslušet	lie with
přít	dispute
zabloudit	stray
zaparkovaný	parked
žrát	eat
cement	cement
měděný	coppery
mozaika	mosaic
schovaný	secret
stupnice	scale
úklid	cleanup
Volkswagen	Volkswagen
zákonodárce	legislator
polít	spill
popovídat	chat
prastarý	immemorial
mračno	cloud
testování	Testing
velmoc	superpower
zahrnující	inclusive
doplňkový	supplementary
islám	Islam
kuřecí	chicken
Luboš	Lubos
Wally	Wally
hedvábí	silk
paralelní	parallel
povídal	said
rozpětí	span
cítění	sentiment
ochranka	security
patent	patent
perský	Persian
slabina	weakness
sněm	parliament
stoprocentní	wholly owned
UK	UK
Boris	Boris
myslitelný	thinkable
natahovat	wind up
navrch	top
obrovitý	monstrous
popravit	execute
týn	týn
hřebík	nail
nesouhlas	disagreement
tlumený	subdued
ublížení	hurt
Wagner	Wagner
upřený	fixed
Ajla	Ajla
Jarmila	Jarmila
nájezd	raid
prvně	first
přisvědčit	agree with
půlhodina	half an hour
rezignace	resignation
šíře	width
vystavovatel	exhibitor
zavěšený	suspended
metafora	metaphor
ovládaný	operated
Pablo	Pablo
přídavek	encore
recese	recession
schválně	on purpose
Srb	Serb
upozornění	notice
vločka	flake
anténa	antenna
diplomacie	diplomacy
docílit	attain
dohadovat	arguing
náklonnost	affection
nálet	raid
umírající	dying
napojit	connect
pondělní	Monday
silueta	silhouette
duha	rainbow
Johnson	Johnson
nájemní	lease
trojúhelník	triangle
vyváznout	escape
Č	No.
geometrický	geometrical
kardinál	cardinal
UEFA	UEFA
vyvrátit	refute
Slávek	Mussels
uklonit	bow
žádaný	desired
civět	gape
evoluce	Evolution
novinový	newspaper
referát	paper
uvažování	thinking
vyslanec	envoy
zmást	confound
loďka	boat
oprávnit	authorize
šít	sew
škůdce	pest
zabavit	confiscate
autonomní	autonomous
konkurenceschopnost	Competitiveness
kubánský	Cuban
pokrájený	chopped
vnést	bring
zamčený	locked
Bohemians	Bohemians
optimalizace	Optimization
uškodit	harm
vyhovující	satisfactory
France	France
hloub	depth
Lisa	Lisa
odebírat	subscribe
stažený	downloaded
župan	bathrobe
totalitní	totalitarian
zmenšovat	shrink
objetí	hug
požární	fire
skalnatý	rocky
spoušť	release
vlastenecký	patriotic
atribut	attribute
koeficient	coefficient
lilek	eggplant
seznamovat	to acquaint
služebník	servant
velikonoční	Easter
agrese	aggression
kmitočet	frequency
konsolidační	Consolidation
sestávat	consist of
specializovat	specialize
zárodek	fetus
duševně	intellectually
procesor	processor
roztáhnout	stretch
hliníkový	Aluminum
jitro	morning
kultus	kultus
dozorce	supervisor
kukuřice	corn
r	r
udát	happen
bál	worried
derby	Derby
dochovat	dochovat
dostih	race
ekolog	ecologist
fragment	fragment
končina	region
reliéf	relief
sanace	redevelopment
vesta	vest
Klausův	Klaus
matrace	mattress
meziročně	year
nastrouhaný	grated
pěchota	infantry
prodaný	sold
přemístit	move
realizovaný	realized
rozložení	decomposition
usedlost	homestead
aktovka	satchel
beránek	lamb
Beroun	Beroun
džíny	jeans
federativní	federative
kožich	fur
vklouznout	slip into
fax	fax
inu	inu
koncový	end
penis	penis
vdaný	married
bublina	bubble
knír	mustache
Major	Major
orientační	tentative
poddaný	subject
ukládání	saving
ukrytý	hidden
pokazit	ruin
stotisíc	one hundred thousand
zletilý	an adult
Alfréd	Alfred
předání	handover
vynaložit	expend
vztyčit	raise
Kučera	Curl
nádherně	beautifully
namočit	soak
normalizace	normalization
potrat	abortion
přízvuk	accent
pšenice	wheat
útulek	shelter
utvářet	shape
Z	Z
dekorace	decoration
hrstka	handful
plošný	printed
podepisovat	sign
postačit	suffice
pružnost	flexibility
Ulrika	Ulrika
velkoměsto	city
vztekle	Angrily
blues	blues
Clinton	Clinton
kandidátský	candidate
laskavost	kindness
rehabilitace	rehabilitation
vůl	ox
vysloužit	earn
manipulovat	handle
pop	pop
sestup	descent
Jules	Jules
komnata	Chamber
koncentrační	Concentration
obrněný	armored
Sýrie	Syria
tázat	ask
versus	versus
vypůjčit	borrow
dotazník	questionnaire
hnusný	beastly
kontaktovat	contact
sliznice	mucous membrane
splácet	repay
svérázný	racy
šikmý	oblique
balit	packing
vstřelit	score
vyčíslit	quantify
hořčice	mustard
Ignácius	Ignatius
kolona	column
stočit	coil
tenista	tennis player
vyčerpání	exhaustion
faraón	Pharaoh
psychicky	psychically
rozený	born
sameček	mate
stěhování	migration
zahodit	throw away
zvěst	rumor
dioda	Diode
hrdě	proudly
mnout	rub
mýt	wash
nechuť	aversion
překladatel	translator
říšský	imperial
střelecký	Shooting
talentovaný	talented
těžiště	center of gravity
troufnout	venture
utrácet	spending
závist	envy
Federico	Federico
stolička	stool
vinařský	Wine
zničehonic	out of nowhere
zvrátit	reverse
českomoravský	Českomoravský
kázeň	discipline
krytina	covering
kulomet	machine-gun
kupé	coupe
maršál	marshal
předpovídat	forecast
revize	review
rezidence	residence
sklánět	bow
srpnový	August
tuhle	this
uhnout	duck
expedice	expedition
Letná	Letná
mramorový	marble
narůst	increase
obsazený	occupied
šílenec	madman
hraný	Feature
logo	logo
Mirek	Mirek
občerstvení	refreshment
odlišit	distinguish
otravovat	bother
prosperita	prosperity
převrátit	overturn
zarostlý	ingrowing
blbost	crap
emigrant	emigrant
hypoteční	Mortgage
míček	ball
nádech	tint
řezník	butcher
skladování	storage
povýšit	upgrade
putování	pilgrimage
seskupení	groupings
zhlédnout	holiday
Napoleon	Napoleon
klepat	knock
velryba	whale
žalovat	sue
lanovka	cableway
lešení	scaffolding
nadávka	invective
reflexe	Reflection
tatra	Tatra
implementace	implementation
Miles	Miles
narušení	disruption
sekretariát	secretariat
taxikář	cabbie
tyčinka	stamen
zatelefonovat	call up
doručit	deliver
filmař	film maker
mech	moss
promyšlený	thought-out
svačina	Snack
Michaela	Michaela
poslušný	submissive
vypátrat	track down
civilista	civilian
dohlédnout	to see
izolovat	isolate
lhostejnost	indifference
naléhavě	urgently
pánský	men
polární	polar
převážný	major
úrodný	fertile
klimatický	climatic
Mister	Mister
přicházející	coming
celer	celery
filharmonie	philharmonic
krystal	crystal
Kryštof	Kitts
třít	rub
uhličitý	carbonic
vyléčit	cure
zmrzlina	ice cream
Bohemia	Bohemia
brzdit	brake
cestovatel	traveler
demonstrant	demonstrator
kamsi	somewhere
lopatka	scoop
měď	copper
Mozart	Mozart
podpatek	heel
porovnávat	Compare
přistěhovalec	immigrant
souhrn	summary
hypermarket	hypermarket
kazatel	preacher
povedený	hilarious
rozplynout	go by the board
typicky	typically
zatížit	encumber
evidovat	register
kriminál	jail
Kristián	Kristian
nakladatel	publisher
FC	FC
francouzsky	French
kmín	cumin
ošetřovatelka	nurse
salám	salami
sójový	soya
tvaroh	curd
jednatel	secretary
náhodně	casually
olovo	lead
poslušně	obediently
požitek	pleasure
připevnit	fasten
systematicky	systematically
žárlivost	jealousy
čtvrtfinále	Quarterfinals
diskusní	discussion
katastrofální	disastrous
Mike	Mike
Pavla	Pavla
protivný	disagreeable
rebel	rebel
udržování	upkeep
vodítko	guide
vytrvale	steadily
efektivita	effectiveness
něčí	someone
nejeden	many
odsuzovat	condemn
podceňovat	underestimated
vyhřátý	heated up
izolační	insulating
jednorázový	disposable
jihoafrický	South African
jižně	south
nauka	science
odlehlý	remote
Antonio	Antonio
koupel	bath
Pákistán	Pakistan
procesní	procedural
puk	puck
učiliště	training institution
hráčka	player
krutost	cruelty
strejček	Uncle
utvořit	form
zdánlivý	apparent
brazilský	Brazilian
čistírna	laundry
napadený	attacked
obklopený	Surrounded
odříznout	cut off
porodní	Birth
Post	Post
prostorný	spacious
CZ	GB
diktátor	dictator
hliněný	earthen
Kafka	Kafka
libovat	Thriving
podmínit	subject
primář	senior consultant
prohrávat	losing
užitkový	utilitarian
vysypat	dump
ema	ema
plíseň	blight
prověřovat	check
stařík	old man
zraky	eyes
žasnout	marvel
akvizice	acquisitions
Balkán	Balkans
nedorozumění	misunderstanding
třináctý	thirteenth
recyklace	recycling
Pierre	Pierre
strašit	haunt
Viktoria	Viktoria
ženich	groom
houpat	swing
napadení	attack
nasazený	pitched
prémie	bonus
přenosový	Transmission
rozevřít	unfold
támhle	there
vzkázat	send word
odpuštění	forgiveness
přídavný	additional
říčka	creek
vydavatelství	Publishing
bankomat	ATM
Celia	Celia
chorvatský	Croatian
koňak	cognac
milování	love
takt	tact
alpa	ALP
flétna	flute
myslivec	gamekeeper
poetický	poetic
pramenit	spring
rozebírat	analyze
rozloučená	Separated
El	El
chvilička	half a minute
přehnat	overstate
rozmanitost	diversity
zastaralý	obsolete
lido	lido
podělit	share
přeplněný	crowded
svázaný	tied
bojiště	battlefield
nálepka	sticker
nebožtík	deceased
Parkhill	Parkhill
polknout	gulp
publikovaný	published
rukojmí	hostage
rychlostní	Speed
štěně	puppy
kdoví	who knows
neznámý	unknown
Palacký	Palacky
předávání	transmission
sedat	subside
tělocvična	gym
tlama	muzzle
avenue	avenue
měnící	changing
provždy	forever
černošský	Negro
doména	domain
kondice	fitness
příval	gush
relevantní	relevant
Ruda	Ore
sériový	serial
flóra	flora
kodex	code
mající	having
polykat	swallow
vytrvalý	unremitting
význačný	outstanding
zvrat	reversal
číhat	watch
Hynek	Hynek
inženýrský	Engineering
pohledný	comely
recenze	review
světle	light
udělení	conferment
usnadňovat	facilitate
znepokojovat	worry
dosažitelný	achievable
přenechat	leave
štvát	chase
znásilnění	rape
zrudnout	blush
Budapešť	Budapest
léčivý	medicinal
ponechávat	leave
poplach	alarm
tvořící	forming
vytlačit	squeeze out
hruška	pear
ilegální	illegal
klíček	sprout
krajně	extremely
odhodlání	resolve
rosický	Rosicky
rytmický	rhythmic
dokumentární	documentary
frakce	faction
Julius	Julius
krůček	step
narušovat	disturb
pohánět	actuate
rafinovaný	refined
uživit	make a living
ambiciózní	ambitious
chladně	coldly
kašlat	cough
vyjímat	remove
děkan	dean
legitimní	legitimate
mák	poppy
přizpůsobovat	customize
snědý	swarthy
učedník	apprentice
vyřizovat	transact
zablokovat	block
kometa	comet
Ludmila	Ludmila
napomoci	help
švestka	plum
troška	touch
Angela	Angela
Dieter	Dieter
chladno	cold
severozápad	northwest
zabiják	killer
zasednout	sit
zástupkyně	Deputy
cvrček	cricket
dravý	predatory
drogový	drug
samostatnost	independence
sklopit	folded
propagační	Promotional
Svěrák	Vice
zabraňovat	obstruct
oblastní	regional
součinnost	cooperation
pokraj	brink
účelný	effective
zaparkovat	park
klávesnice	keyboard
mítink	rally
montážní	assembly
rozzářit	shine
signalizovat	signaling
zahalit	enshroud
zbarvení	coloring
zbožňovat	idolize
Candy	Candy
nadsázka	hyperbole
pětatřicet	thirty-five
podlaží	storey
pokora	humility
poškozovat	harm
privátní	Private
želva	turtle
odměnit	reward
přemluvit	coax
sedávat	sit
sekretář	secretary
vernisáž	opening
zubní	dental
movitý	movable
National	National
oddat	marry
propuknout	burst out
razantní	penetrative
římsa	cornice
žebrák	beggar
archeolog	archaeologist
kriticky	critically
obvodní	District
přemýšlení	thinking
splatnost	maturity
vděčnost	gratitude
Barbora	Barbora
kamínek	stone
Luke	Luke
Srbsko	Serbia
zástěra	apron
čeleď	family
Toyota	Toyota
vyhodnotit	evaluate
výpočetní	computational
brouk	beetle
Jozef	Jozef
klenot	gem
Nobelův	Nobel
obratný	adroit
okrást	rob
underground	underground
vyvážit	outweigh
vyznamenání	commendation
květinový	floral
laso	lasso
minus	minus
obklad	poultice
sjednotit	unite
zabezpečovat	securing
západoevropský	Western European
instrument	instrument
máj	May
manévr	maneuver
referenční	Reference
únosný	bearable
vzdor	defiance
zpětně	retroactively
dědičný	hereditary
kopyto	hoof
myslitel	thinker
nakazit	infect
naskytnout	present itself
navazující	follow
PC	PC
řidičský	driving
sametový	velvety
vyvodit	draw
zástava	pledge
doplněný	complete
eliminovat	eliminate
Linda	Linda
meziroční	YoY
náležitost	requirement
polička	shelf
tleskat	applaud
vnitřně	internally
zubař	dentist
zvolení	election
Bosna	Bosnia
kop	kick
kousnout	bite
legrační	funny
poklička	lid
pokračující	ongoing
povel	command
rozhled	outlook
vodorovný	horizontal
zázvor	ginger
bavorský	Bavarian
dědic	heir
imunitní	Immune
jablonecký	Jablonec
seno	hay
sexualita	sexuality
bezplatný	free
míchání	agitation
šplhat	climb
holocaust	Holocaust
kázání	sermon
pověstný	notorious
zatvářit	look
zneužívat	abuse
adekvátní	suitable
figurovat	figure
junior	junior
Leo	Leo
odnášet	carry away
tvořený	formed
závodní	competitive
detailní	detailed
Husajn	Hussein
ponětí	idea
rádiový	radio
transplantace	transplantation
zdvořilý	polite
odněkud	from somewhere
příchozí	arrival
vyhradit	reserve
zlom	fault
zrcátko	mirror
devizový	Foreign Exchange
Elisabeth	Elisabeth
knihkupectví	bookstore
ožít	come back to life
přežívat	surviving
ucelený	integrated
víko	cover
dlužný	due
dráždit	tease
Jondalar	Jondalar
konzultace	consultation
líc	obverse
obuv	shoes
řezný	cutting
sekta	sect
totožný	identical
Irena	Irena
Karviná	Karvina
prodávající	seller
Blair	Blair
Blšany	Blšany
certifikát	certificate
empirický	empirical
léčebna	Treatment Center
lednička	refrigerator
zpochybnit	to challenge
asistence	assistance
Kamila	Kamila
lak	varnish
osmnáctý	eighteenth
rázně	sharply
banda	gang
desetina	tenth
Nick	Nick
podlít	basted
úbytek	decrease
většinový	Majority
op	op
Petra	Petra
pochybný	doubtful
prokurátor	prosecutor
recepce	reception
úsporný	saving
váhání	hesitation
baba	hag
diskriminace	discrimination
José	José
pohlednice	postcards
porušovat	violate
VI	VI
vrcholový	top
vychladnout	cool
vyšetřit	examine
Zuzi	Zuzi
dříví	wood
epocha	epoch
kuchařka	cookbook
odbyt	sales
pitva	autopsy
prezidentův	president
ubytovna	hostel
zhoubný	malignant
pověřený	authorized
souvislý	coherent
kožní	cutaneous
ss	ss
starověký	ancient
uvařený	boiled
vyústit	result
černobílý	black and white
Havlíčkův	Havlíčkův
hrozivý	threatening
ohlížet	looking back
pojistit	insure
porcelán	porcelain
ventil	valve
zmiňovaný	mentioned
Abrahám	Abraham
cpát	Ram
homosexuální	gay
Jenny	Jenny
kancelářský	office
konzervatoř	conservatory
nepokoj	restlessness
padlý	fallen
rezoluce	resolution
ukrývat	shelter
živina	nutritive
nůžky	scissors
zneužít	misuse
ničivý	destructive
penzión	guesthouse
relace	session
testovat	test
bezvědomí	unconsciousness
del	del
fráze	phrases
kázat	preach
kráska	beauty
ohrada	fence
optimistický	optimistic
Pega	Pega
prut	rod
zasvěcený	sacred
zdůvodnit	justify
betlém	crib
lákavý	seductive
lékařka	doctor
nářek	lament
poznávací	cognitive
rozpačitě	sheepishly
sestupovat	go down
so	with
AIDS	AIDS
hradní	castle
oblíbit	take to
řádit	rage
úsvit	dawn
jídelní	dining
prvoligový	first league
zmítat	convulse
emocionální	Emotional
hospodář	husbandman
nadání	talent
ochutnat	sample
šampión	champion
vnitrozemí	inland
zhoršovat	worsen
způsobilost	qualification
odveta	reprisal
oslabení	weakening
uvěznit	jail
vztáhnout	relate
dospívající	teenage
dotyk	touch
podzemí	underground
skladiště	storehouse
střídání	alternation
uzdravit	cure
zavítat	visit
střih	cut
břišní	abdominal
páchnout	stink
pozemkový	landed
požehnání	blessing
problémový	offending
úplatek	bribe
budka	booth
idiot	idiot
něha	tenderness
oprávněně	justly
provázek	string
přednést	perform
roucho	robe
slina	spittle
metodický	methodical
motorista	motorist
redukovat	reduce
deformace	deformation
evidentně	obviously
Chorvatsko	Croatia
koupaliště	swimming pool
Krumlov	Krumlov
mlátit	thresh
opomenout	omit
vynášet	exalt
zuřivě	ferociously
agresivita	aggressiveness
laserový	Laser
viceprezident	vice-president
vystavět	erect
zápal	inflammation
argumentace	argumentation
čí	whose
Flick	Flick
jihovýchod	southeast
obnovitelný	renewable
opřený	leaning
týdenní	weekly
institucionální	Institutional
Jiřina	Dahlia
podílový	podílový
renomovaný	renowned
Florencie	Florence
laik	layman
Sobotka	Sobotka
vyčlenit	earmark
vykřikovat	shout
molo	pier
sousto	morsel
zájmový	interest
ego	ego
Jimmy	Jimmy
opilec	drunk
přemítat	ruminate
Sabina	Sabina
tribunál	tribunal
vak	bag
znemožnit	make impossible
aukce	auction
Dostál	Dostal
kouzelník	magician
misionář	missionary
nervozita	nervousness
preferovat	favor
přehánět	exaggerate
puma	puma
punčocha	stocking
regulovat	regulate
Schröder	Schröder
vyráběný	produced
zaplést	embroil
hlouček	knot
chlup	hair
patron	patron
televizor	television set
esej	essay
lyžování	skiing
mostecký	Most,
propagovat	propagate
stárnout	age
bizarní	bizarre
Luděk	Ludek
psychika	psyche
vrcholit	culminate
zabalený	packed
klávesa	key
otevřenost	openness
poskakovat	flounce
převrat	putsch
citát	quote
četa	squad
chrámový	Temple
Laura	Laura
mravenec	ant
nastartovat	start
pětkrát	five times
přísaha	oath
půjčovat	lend
sociologie	sociology
újma	harm
uzávěr	cap
rvačka	melee
nabírat	scoop
očko	eyelet
počest	honor
průjezd	passage
teror	terror
traktor	tractor
Dušan	Dusan
chodívat	chodívat
osušit	dry
strouhanka	breadcrumbs
variace	variations
imunita	immunity
leknout	frightened
strávený	Spent
udělovat	grant
aréna	arena
ctít	venerate
prestiž	prestige
vzrušovat	excite
zhotovit	make
Mareš	Mares
milá	dear
nadějný	hopeful
řadový	serial
sevřený	pent
účinkovat	have an effect
vinohrad	vineyard
zrno	grain
překážet	interfere
příslušet	lie with
přít	dispute
zabloudit	stray
zaparkovaný	parked
žrát	eat
cement	cement
měděný	coppery
mozaika	mosaic
schovaný	secret
stupnice	scale
úklid	cleanup
Volkswagen	Volkswagen
zákonodárce	legislator
polít	spill
popovídat	chat
prastarý	immemorial
mračno	cloud
testování	Testing
velmoc	superpower
zahrnující	inclusive
doplňkový	supplementary
islám	Islam
kuřecí	chicken
Luboš	Lubos
Wally	Wally
hedvábí	silk
paralelní	parallel
povídal	said
rozpětí	span
cítění	sentiment
ochranka	security
patent	patent
perský	Persian
slabina	weakness
sněm	parliament
stoprocentní	wholly owned
UK	UK
Boris	Boris
myslitelný	thinkable
natahovat	wind up
navrch	top
obrovitý	monstrous
popravit	execute
týn	týn
hřebík	nail
nesouhlas	disagreement
tlumený	subdued
ublížení	hurt
Wagner	Wagner
upřený	fixed
Ajla	Ajla
Jarmila	Jarmila
nájezd	raid
prvně	first
přisvědčit	agree with
půlhodina	half an hour
rezignace	resignation
šíře	width
vystavovatel	exhibitor
zavěšený	suspended
metafora	metaphor
ovládaný	operated
Pablo	Pablo
přídavek	encore
recese	recession
schválně	on purpose
Srb	Serb
upozornění	notice
vločka	flake
anténa	antenna
diplomacie	diplomacy
docílit	attain
dohadovat	arguing
náklonnost	affection
nálet	raid
umírající	dying
napojit	connect
pondělní	Monday
silueta	silhouette
duha	rainbow
Johnson	Johnson
nájemní	lease
trojúhelník	triangle
vyváznout	escape
Č	No.
geometrický	geometrical
kardinál	cardinal
UEFA	UEFA
vyvrátit	refute
Slávek	Mussels
uklonit	bow
žádaný	desired
civět	gape
evoluce	Evolution
novinový	newspaper
referát	paper
uvažování	thinking
vyslanec	envoy
zmást	confound
loďka	boat
oprávnit	authorize
šít	sew
škůdce	pest
zabavit	confiscate
autonomní	autonomous
konkurenceschopnost	Competitiveness
kubánský	Cuban
pokrájený	chopped
vnést	bring
zamčený	locked
Bohemians	Bohemians
optimalizace	Optimization
uškodit	harm
vyhovující	satisfactory
France	France
hloub	depth
Lisa	Lisa
odebírat	subscribe
stažený	downloaded
župan	bathrobe
totalitní	totalitarian
zmenšovat	shrink
objetí	hug
požární	fire
skalnatý	rocky
spoušť	release
vlastenecký	patriotic
atribut	attribute
koeficient	coefficient
lilek	eggplant
seznamovat	to acquaint
služebník	servant
velikonoční	Easter
agrese	aggression
kmitočet	frequency
konsolidační	Consolidation
sestávat	consist of
specializovat	specialize
zárodek	fetus
duševně	intellectually
procesor	processor
roztáhnout	stretch
hliníkový	Aluminum
jitro	morning
kultus	kultus
dozorce	supervisor
kukuřice	corn
r	r
udát	happen
bál	worried
derby	Derby
dochovat	dochovat
dostih	race
ekolog	ecologist
fragment	fragment
končina	region
reliéf	relief
sanace	redevelopment
vesta	vest
Klausův	Klaus
matrace	mattress
meziročně	year
nastrouhaný	grated
pěchota	infantry
prodaný	sold
přemístit	move
realizovaný	realized
rozložení	decomposition
usedlost	homestead
aktovka	satchel
beránek	lamb
Beroun	Beroun
džíny	jeans
federativní	federative
kožich	fur
vklouznout	slip into
fax	fax
inu	inu
koncový	end
penis	penis
vdaný	married
bublina	bubble
knír	mustache
Major	Major
orientační	tentative
poddaný	subject
ukládání	saving
ukrytý	hidden
pokazit	ruin
stotisíc	one hundred thousand
zletilý	an adult
Alfréd	Alfred
předání	handover
vynaložit	expend
vztyčit	raise
Kučera	Curl
nádherně	beautifully
namočit	soak
normalizace	normalization
potrat	abortion
přízvuk	accent
pšenice	wheat
útulek	shelter
utvářet	shape
Z	Z
dekorace	decoration
hrstka	handful
plošný	printed
podepisovat	sign
postačit	suffice
pružnost	flexibility
Ulrika	Ulrika
velkoměsto	city
vztekle	Angrily
blues	blues
Clinton	Clinton
kandidátský	candidate
laskavost	kindness
rehabilitace	rehabilitation
vůl	ox
vysloužit	earn
manipulovat	handle
pop	pop
sestup	descent
Jules	Jules
komnata	Chamber
koncentrační	Concentration
obrněný	armored
Sýrie	Syria
tázat	ask
versus	versus
vypůjčit	borrow
dotazník	questionnaire
hnusný	beastly
kontaktovat	contact
sliznice	mucous membrane
splácet	repay
svérázný	racy
šikmý	oblique
balit	packing
vstřelit	score
vyčíslit	quantify
hořčice	mustard
Ignácius	Ignatius
kolona	column
stočit	coil
tenista	tennis player
vyčerpání	exhaustion
faraón	Pharaoh
psychicky	psychically
rozený	born
sameček	mate
stěhování	migration
zahodit	throw away
zvěst	rumor
dioda	Diode
hrdě	proudly
mnout	rub
mýt	wash
nechuť	aversion
překladatel	translator
říšský	imperial
střelecký	Shooting
talentovaný	talented
těžiště	center of gravity
troufnout	venture
utrácet	spending
závist	envy
Federico	Federico
stolička	stool
vinařský	Wine
zničehonic	out of nowhere
zvrátit	reverse
českomoravský	Českomoravský
kázeň	discipline
krytina	covering
kulomet	machine-gun
kupé	coupe
maršál	marshal
předpovídat	forecast
revize	review
rezidence	residence
sklánět	bow
srpnový	August
tuhle	this
uhnout	duck
expedice	expedition
Letná	Letná
mramorový	marble
narůst	increase
obsazený	occupied
šílenec	madman
hraný	Feature
logo	logo
Mirek	Mirek
občerstvení	refreshment
odlišit	distinguish
otravovat	bother
prosperita	prosperity
převrátit	overturn
zarostlý	ingrowing
blbost	crap
emigrant	emigrant
hypoteční	Mortgage
míček	ball
nádech	tint
řezník	butcher
skladování	storage
povýšit	upgrade
putování	pilgrimage
seskupení	groupings
zhlédnout	holiday
Napoleon	Napoleon
klepat	knock
velryba	whale
žalovat	sue
lanovka	cableway
lešení	scaffolding
nadávka	invective
reflexe	Reflection
tatra	Tatra
implementace	implementation
Miles	Miles
narušení	disruption
sekretariát	secretariat
taxikář	cabbie
tyčinka	stamen
zatelefonovat	call up
doručit	deliver
filmař	film maker
mech	moss
promyšlený	thought-out
svačina	Snack
Michaela	Michaela
poslušný	submissive
vypátrat	track down
civilista	civilian
dohlédnout	to see
izolovat	isolate
lhostejnost	indifference
naléhavě	urgently
pánský	men
polární	polar
převážný	major
úrodný	fertile
klimatický	climatic
Mister	Mister
přicházející	coming
celer	celery
filharmonie	philharmonic
krystal	crystal
Kryštof	Kitts
třít	rub
uhličitý	carbonic
vyléčit	cure
zmrzlina	ice cream
Bohemia	Bohemia
brzdit	brake
cestovatel	traveler
demonstrant	demonstrator
kamsi	somewhere
lopatka	scoop
měď	copper
Mozart	Mozart
podpatek	heel
porovnávat	Compare
přistěhovalec	immigrant
souhrn	summary
hypermarket	hypermarket
kazatel	preacher
povedený	hilarious
rozplynout	go by the board
typicky	typically
zatížit	encumber
evidovat	register
kriminál	jail
Kristián	Kristian
nakladatel	publisher
FC	FC
francouzsky	French
kmín	cumin
ošetřovatelka	nurse
salám	salami
sójový	soya
tvaroh	curd
jednatel	secretary
náhodně	casually
olovo	lead
poslušně	obediently
požitek	pleasure
připevnit	fasten
systematicky	systematically
žárlivost	jealousy
čtvrtfinále	Quarterfinals
diskusní	discussion
katastrofální	disastrous
Mike	Mike
Pavla	Pavla
protivný	disagreeable
rebel	rebel
udržování	upkeep
vodítko	guide
vytrvale	steadily
efektivita	effectiveness
něčí	someone
nejeden	many
odsuzovat	condemn
podceňovat	underestimated
vyhřátý	heated up
izolační	insulating
jednorázový	disposable
jihoafrický	South African
jižně	south
nauka	science
odlehlý	remote
Antonio	Antonio
koupel	bath
Pákistán	Pakistan
procesní	procedural
puk	puck
učiliště	training institution
hráčka	player
krutost	cruelty
strejček	Uncle
utvořit	form
zdánlivý	apparent
brazilský	Brazilian
čistírna	laundry
napadený	attacked
obklopený	Surrounded
odříznout	cut off
porodní	Birth
Post	Post
prostorný	spacious
CZ	GB
diktátor	dictator
hliněný	earthen
Kafka	Kafka
libovat	Thriving
podmínit	subject
primář	senior consultant
prohrávat	losing
užitkový	utilitarian
vysypat	dump
ema	ema
plíseň	blight
prověřovat	check
stařík	old man
zraky	eyes
žasnout	marvel
akvizice	acquisitions
Balkán	Balkans
nedorozumění	misunderstanding
třináctý	thirteenth
recyklace	recycling
Pierre	Pierre
strašit	haunt
Viktoria	Viktoria
ženich	groom
houpat	swing
napadení	attack
nasazený	pitched
prémie	bonus
přenosový	Transmission
rozevřít	unfold
támhle	there
vzkázat	send word
odpuštění	forgiveness
přídavný	additional
říčka	creek
vydavatelství	Publishing
bankomat	ATM
Celia	Celia
chorvatský	Croatian
koňak	cognac
milování	love
takt	tact
alpa	ALP
flétna	flute
myslivec	gamekeeper
poetický	poetic
pramenit	spring
rozebírat	analyze
rozloučená	Separated
El	El
chvilička	half a minute
přehnat	overstate
rozmanitost	diversity
zastaralý	obsolete
lido	lido
podělit	share
přeplněný	crowded
svázaný	tied
bojiště	battlefield
nálepka	sticker
nebožtík	deceased
Parkhill	Parkhill
polknout	gulp
publikovaný	published
rukojmí	hostage
rychlostní	Speed
štěně	puppy
kdoví	who knows
neznámý	unknown
Palacký	Palacky
předávání	transmission
sedat	subside
tělocvična	gym
tlama	muzzle
avenue	avenue
měnící	changing
provždy	forever
černošský	Negro
doména	domain
kondice	fitness
příval	gush
relevantní	relevant
Ruda	Ore
sériový	serial
flóra	flora
kodex	code
mající	having
polykat	swallow
vytrvalý	unremitting
význačný	outstanding
zvrat	reversal
číhat	watch
Hynek	Hynek
inženýrský	Engineering
pohledný	comely
recenze	review
světle	light
udělení	conferment
usnadňovat	facilitate
znepokojovat	worry
dosažitelný	achievable
přenechat	leave
štvát	chase
znásilnění	rape
zrudnout	blush
Budapešť	Budapest
léčivý	medicinal
ponechávat	leave
poplach	alarm
tvořící	forming
vytlačit	squeeze out
hruška	pear
ilegální	illegal
klíček	sprout
krajně	extremely
odhodlání	resolve
rosický	Rosicky
rytmický	rhythmic
dokumentární	documentary
frakce	faction
Julius	Julius
krůček	step
narušovat	disturb
pohánět	actuate
rafinovaný	refined
uživit	make a living
ambiciózní	ambitious
chladně	coldly
kašlat	cough
vyjímat	remove
děkan	dean
legitimní	legitimate
mák	poppy
přizpůsobovat	customize
snědý	swarthy
učedník	apprentice
vyřizovat	transact
zablokovat	block
kometa	comet
Ludmila	Ludmila
napomoci	help
švestka	plum
troška	touch
Angela	Angela
Dieter	Dieter
chladno	cold
severozápad	northwest
zabiják	killer
zasednout	sit
zástupkyně	Deputy
cvrček	cricket
dravý	predatory
drogový	drug
samostatnost	independence
sklopit	folded
propagační	Promotional
Svěrák	Vice
zabraňovat	obstruct
oblastní	regional
součinnost	cooperation
pokraj	brink
účelný	effective
zaparkovat	park
klávesnice	keyboard
mítink	rally
montážní	assembly
rozzářit	shine
signalizovat	signaling
zahalit	enshroud
zbarvení	coloring
zbožňovat	idolize
Candy	Candy
nadsázka	hyperbole
pětatřicet	thirty-five
podlaží	storey
pokora	humility
poškozovat	harm
privátní	Private
želva	turtle
odměnit	reward
přemluvit	coax
sedávat	sit
sekretář	secretary
vernisáž	opening
zubní	dental
movitý	movable
National	National
oddat	marry
propuknout	burst out
razantní	penetrative
římsa	cornice
žebrák	beggar
archeolog	archaeologist
kriticky	critically
obvodní	District
přemýšlení	thinking
splatnost	maturity
vděčnost	gratitude
Barbora	Barbora
kamínek	stone
Luke	Luke
Srbsko	Serbia
zástěra	apron
čeleď	family
Toyota	Toyota
vyhodnotit	evaluate
výpočetní	computational
brouk	beetle
Jozef	Jozef
klenot	gem
Nobelův	Nobel
obratný	adroit
okrást	rob
underground	underground
vyvážit	outweigh
vyznamenání	commendation
květinový	floral
laso	lasso
minus	minus
obklad	poultice
sjednotit	unite
zabezpečovat	securing
západoevropský	Western European
instrument	instrument
máj	May
manévr	maneuver
referenční	Reference
únosný	bearable
vzdor	defiance
zpětně	retroactively
dědičný	hereditary
kopyto	hoof
myslitel	thinker
nakazit	infect
naskytnout	present itself
navazující	follow
PC	PC
řidičský	driving
sametový	velvety
vyvodit	draw
zástava	pledge
doplněný	complete
eliminovat	eliminate
Linda	Linda
meziroční	YoY
náležitost	requirement
polička	shelf
tleskat	applaud
vnitřně	internally
zubař	dentist
zvolení	election
Bosna	Bosnia
kop	kick
kousnout	bite
legrační	funny
poklička	lid
pokračující	ongoing
povel	command
rozhled	outlook
vodorovný	horizontal
zázvor	ginger
bavorský	Bavarian
dědic	heir
imunitní	Immune
jablonecký	Jablonec
jednostranný	one-sided
korejský	Korean
publicista	publicist
včasný	early
Wilson	Wilson
Barcelona	Barcelona
bronz	bronze
dopouštět	commit
Mojžíš	Moses
padající	falling
portugalský	Portuguese
poslušnost	obedience
rozkvět	florescence
sirotek	orphan
veš	louse
bříško	tummy
kmenový	tribal
maják	lighthouse
plemeno	breed
pokynout	beckon
stoprocentně	definitely
ubrousek	doily
zuřivý	furious
Czech	Czech
hlavice	capital
World	World
kli	cli
liberalizace	liberalization
Ormus	Ormus
ospalý	sleepy
pomale	slow
Quinn	Quinn
spojovací	connecting
strojní	machine
vítězit	win
zasunout	slide
zkomplikovat	complicate
deštník	umbrella
kšeft	racket
nudlička	noodle
réva	vine
vesničan	villager
vynutit	enforce
zámořský	overseas
kvalitativní	qualitative
podsvětí	underworld
senátní	Senate
tolerovat	tolerate
vůdčí	leading
zbrojní	arms
čtverec	square
hřát	warm
hygiena	hygiene
kuřák	smoker
Kypr	Cyprus
podnebí	climate
převodovka	transmission
temně	darkly
vyhazovat	throw away
vychutnávat	enjoy
zprostředkovat	convey
dívenka	girl
horizontální	horizontal
močový	urine
Shakespeare	Shakespeare
afghánský	Afghan
Bož	Of God
čaroděj	wizard
dramaticky	dramatically
motorka	motorbike
obsluhovat	operate
splatit	repay
tenhleten	this one
usínat	sleep
bombardování	bombing
masáž	massage
úctyhodný	venerable
udat	state
únavný	tiresome
ustavičně	incessantly
Larry	Larry
Leopold	Leopold
mzdový	Wages
ručička	needle
široko	wide
toxický	toxic
vyhlašovat	announce
vyznávat	worship
zachraňovat	rescue
odboj	revolt
Patrik	Patrick
samo	itself
sudí	Judges
zavrčet	growl
foukat	blow
chovatel	breeder
rozebrat	dismantle
statný	portly
topný	Heating
Forrest	Forrest
přistání	landing
spálený	burnt
větvička	twig
výběžek	spit
zatěžovat	burden
zrod	birth
důstojně	dignity
kontrolovaný	Controlled
Ládin	Laden
představený	introduced
složitost	complexity
ustavit	establish
uváděný	featured
zobák	beak
karosérie	bodywork
realismus	realism
řezat	cut
společensky	socially
VB	UK
West	West
atlet	athlete
Cave	Cave
komfort	comfort
malér	scrape
malovaný	painted
mezní	limit
urážet	insult
bába	old woman
desetkrát	ten times
dobrodružný	adventurous
Fin	Finn
kompenzace	compensation
Louny	Louny
měšťanský	burgess
odkazovat	reference
podvozek	chassis
půldruhý	Ninety
rozhodovací	decision
sklidit	clear away
teologie	theology
ubrus	cloth
žampion	mushroom
žralok	shark
banální	banal
Detroit	Detroit
diagnostický	diagnostic
kreditní	Credit
rozeznávat	distinguish
různorodý	varied
spojitost	connection
vítaný	welcome
vyhlédnout	peer
arcibiskup	archbishop
hybný	motive
Morgan	Morgan
nabádat	urge
pomstít	revenge
smečka	pack
spravit	mend
vystupování	manner
žurnalista	journalist
Andy	Andes
kladenský	Kladno
komentátor	commentator
masakr	massacre
národnostní	national
účelový	purpose-built
uhlík	carbon
uhodnout	guess
váza	vase
Barbara	Barbara
madam	madam
mars	mars
povodí	basin
starostka	mayoress
kontinentální	continental
přiměřeně	adequately
spára	gap
Mělník	Melnik
objektivně	objectively
orlice	eagle
předstih	advance
šev	seam
tuzemsko	Domestic
zrnko	grain
číslice	digit
elementární	elementary
herní	Gaming
nížina	lowland
dýka	dagger
finálový	Final
současník	contemporary
vysvědčení	certificate
fazole	beans
orientální	Oriental
rallye	Rally
rozpoutat	unleash
sporně	controversially
vrstevník	contemporary
vymezovat	define
agrární	agrarian
Danny	Danny
dřít	rub
Hugh	Hugh
klášterní	monastic
krycí	cover
očkování	vaccination
pastvina	pasture
připojovat	connect
tištěný	printed
uskupení	groups
vychladlý	cooled down
pat	stalemate
trpící	sufferers
utěšovat	comfort
Vlastimil	Vlastimil
benátský	Venetian
hučet	hum
charita	charity
listovat	browse
Manchester	Manchester
oddanost	dedication
prohledat	search
štítek	label
třídění	classification
zalíbit	please
zmáčknout	squeeze
zranitelný	vulnerable
červnový	June
čip	chip
kosmetický	cosmetic
obývák	living room
okouzlit	enrapture
platforma	platform
propojený	Linked
západočeský	Westbohemian
archív	archive
kočárek	stroller
konzumace	eating
polední	midday
popelnice	dustbin
připojený	attached
via	via
vyniknout	excel
malebný	picturesque
moravskoslezský	moravskoslezsky
osolený	salted
peřina	featherbed
razit	mint
reprezentativní	representative
nával	rush
nosní	nasal
Ondra	Ondra
vražedný	murder
ambasáda	embassy
hrdinka	heroine
kopí	spear
milionář	millionaire
vjem	sensation
živobytí	living
bažina	swamp
dodržení	compliance
extrémně	Extremely
facto	facto
Kennedy	Kennedy
napravo	right
osnova	outline
štětec	brush
vysílačka	transmitter
zákulisí	behind the scenes
zaznívat	resound
generátor	generator
lopata	shovel
ohromit	astound
plynulý	smooth
Renault	Renault
top	top
vnitřek	interior
zastrčit	tuck
dílec	component
kopírovat	copy
sekera	ax
spotřebič	appliance
střep	shard
amatér	amateur
Cimrman	Cimrman
kandidatura	candidacy
Kelly	Kelly
munice	ammunition
přihrávka	pass
růstový	Growth
vánek	breeze
vášnivě	heatedly
Frankfurt	Frankfurt
hluchý	deaf
prodávaný	sold
siréna	siren
SMS	SMS
Thorn	Thorn
vzrušeně	excitedly
zatočit	turn
zjev	appearance
hrabal	rummaged
iont	ion
náležitě	properly
napodobit	imitate
odvažovat	weigh
placka	cake
projednávání	hearing
sousedka	neighbor
tetička	auntie
Anička	Anička
děvka	whore
gigant	titan
katastr	cadastre
mučit	torture
nahrávat	record
násilník	rapist
pozůstalý	residuary
průřez	cross-section
převádět	convert
Rose	Rose
sociolog	sociologist
vrátný	porter
znenadání	unawares
celebrita	celebrity
hemžit	teem
Nat	Nat
průměrně	average
rozpadat	crumble
střevíc	shoe
vařící	boiling
vtáhnout	pull in
bednění	Formwork
dealer	dealer
motat	wind up
nuže	Well
opodál	aloof
praskat	creak
ztuhlý	stiff
geologický	geological
MV	MV
obdivuhodný	admirable
podélný	longitudinal
potit	perspire
předložený	submitted
trn	thorn
elegance	elegance
integrovat	integrate
misie	Missions
postřeh	observation
špaček	starling
garda	guard
choť	consort
přízemní	ground
rekonstruovat	reconstruct
vida	vida
výzbroj	equipment
zbarvený	colored
zrychlit	accelerate
auditor	auditor
názorový	of opinion
obalit	wrap
správnost	rightness
víla	fairy
vraždit	murder
Williams	Williams
bit	bit
dohodnutý	Agreed
estetika	aesthetics
chovanec	inmate
mrav	manners
plavky	swimsuit
prospívat	thrive
prozatímní	interim
revue	revue
šetrný	thrifty
tekutý	liquid
teplotní	thermal
vymazaný	deleted
zadavatel	authority
dynastie	dynasty
lednice	fridge
pískat	whistle
pokřtít	christen
přislíbit	vow
Ronny	Ronny
rybička	tiddler
vypravěč	Narrator
Carl	Carl
kvóta	quota
palubní	board
pamětní	memorial
patnáctý	fifteenth
přidržovat	hold
dovážet	import
dvojka	Pair
hojný	abundant
peníz	coin
podezírat	suspect
skleník	greenhouse
vkročit	walk in
vodit	walk
vstřícný	helpful
divně	weird
naložený	loaded
pohraniční	border
poklidný	placid
spěšně	hastily
SR	SR
vršek	top
zlatka	Zlatko
Company	Company
invalidní	disabled
křivda	injustice
opar	haze
pokojný	peaceful
rušný	eventful
zahajovat	launch
zvědavě	curiously
čtyřicátý	fortieth
Ráchel	Rachel
viditelně	visibly
vpadnout	raid
biskupský	episcopal
hraběnka	countess
pootevřený	ajar
posedlost	obsession
postěžovat	Complain
servisní	service
telekomunikace	telecommunication
výmluvný	eloquent
zásobovat	supply
horák	burner
koridor	corridor
kytarista	Guitarist
monumentální	monumental
osvojit	learn
regulovaný	controlled
rozruch	stir
šerif	sheriff
velkorysý	generous
čitelný	readable
konstantní	constant
lávka	footbridge
Litva	Lithuania
pást	graze
přehlížet	disregard
roztrhnout	rip
uhánět	scud
zaujetí	absorption
klesající	decreasing
naskočit	hop on
novinářský	journalistic
osel	donkey
part	part
pH	pH
postih	recourse
ježto	because
kalifornský	Californian
stesk	nostalgia
suverenita	sovereignty
trans	trance
výpis	listing
atletický	athletic
cožpak	Had
mluvící	speaking
obsáhlý	comprehensive
pořízení	acquisition
registrovaný	registered
sjíždět	go down
vtisknout	impress
záchranka	ambulance
děs	dread
dostavět	finish
Kraus	Kraus
nalezení	finding
palička	gavel
příkrý	steep
přísun	feed
slast	delight
sopka	volcano
sranda	hoot
syntetický	synthetic
nalevo	on the left
pečeť	seal
samopal	tommy gun
Macintosh	Macintosh
republikánský	republican
udiveně	in astonishment
unaveně	weary
vydírání	extortion
výztuž	Reinforcement
zastupitelství	Prosecution
zkažený	corrupt
air	air
biologie	biology
blahobyt	welfare
doprostřed	middle
dvaadvacet	Twenty-two
hrabat	scrabble
hydraulický	hydraulic
kytka	flower
Lee	Lee
představitelný	imaginable
úměrný	proportional
blbec	jerk
Daniela	Daniela
povstalec	insurrectionist
rival	rival
rozdrtit	crush
směle	boldly
soška	statuette
velikonoce	Easter
hoře	mountain
objektiv	lens
pilně	diligently
posledně	last
varovný	warning
legálně	legally
malování	painting
mihnout	flicker
mile	mile
oddechnout	breather
pochodeň	torch
přesahující	exceeding
rasový	race
receptor	receptor
reformní	reform
svíce	Candles
štěkat	bark
vyjednávat	negotiate
zrzavý	ginger
klimatizace	air conditioning
Náchod	Nachod
pohrávat	fool
šipka	arrow
vyplňovat	fill
zveřejněný	published
bodový	Scatter
odpadový	waste
podvečer	evening
rozumně	reasonably
východočeský	East Bohemia
duchový	spectral
hustě	thick
královéhradecký	Hradec Kralove
radikálně	radically
šlápnout	tread
teplický	Teplice
vegetace	vegetation
vyvolený	Chosen
branže	branch
drátěný	wire
Izraelec	Israeli
kolébka	cradle
koncovka	ending
stropní	Ceiling
učenec	scholar
Zéland	Zealand
obchvat	envelopment
obratně	ably
ploutev	flipper
prolomit	break
Rýn	Rhine
selský	rural
středeční	Wednesday
štěrbina	slot
vlažný	lukewarm
vyklouznout	slip out
životně	vitally
BMW	BMW
Erik	Erik
husí	goose
chápavě	knowingly
nezájem	lack of interest
pasta	paste
port	port
pozvánka	invitation card
šum	noise
vietnamský	Vietnamese
zálivka	dressing
alej	alley
klání	tilt
odbočit	digress
senzace	sensation
setrvat	persevere
slavík	nightingale
tržnice	Market
alergie	allergy
celoroční	yearlong
destička	tablet
larva	larva
mafie	mafia
meziříčí	meziříčí
Mick	Mick
republikán	republican
sekvence	sequence
kostní	Bone
množit	proliferate
surrealismus	surrealism
šach	shah
vyplout	sail
Deutsche	Deutsche
die	die
Duncan	Duncan
kotva	anchor
perfektně	perfectly
pětka	fiver
pravdivost	verity
střelit	shoot
surový	raw
vidlička	fork
výkyv	swing
chemikálie	chemicals
ironický	ironic
náležitý	due
ozdobný	fancy
sirka	match
úlomek	fragment
hajzl	cunt
sčítání	summing up
světnice	sitting room
tamější	local
tamten	yonder
uběhnout	elapse
extraligový	extraleague
hvězdička	asterisk
roztrhat	tear
Vratislav	Vratislav
diplom	diploma
chlupatý	hairy
kompromisní	Compromise
kytovec	grampus
Roger	Roger
vloupání	housebreaking
zábavní	Entertainment
zdatný	able-bodied
doznat	admit
drzý	sassy
Euro	Euro
Karla	Karla
líný	lazy
příbytek	abode
sebedůvěra	self-confidence
sedačka	seat
cyklistický	cycling
drobnost	trifle
idol	heartthrob
jez	is from
klečet	kneel
nastavený	default
palivový	fuel
přiřadit	assign
saudský	Saudi
Sokolov	Sokolov
telefonický	telephonic
trakt	tract
domlouvat	play
dusík	nitrogen
justice	judiciary
klacek	stick
nesčetný	numberless
pomyslný	imaginary
pořádaný	organized
slůvko	word
souběžně	concurrently
útlum	downturn
výšina	height
zmrzlý	frozen
čokoládový	chocolate
labyrint	labyrinth
poradna	clinic
sólový	solo
teoretik	theoretician
vlnový	wave
kolovat	circulate
linout	waft
příslušenství	accessories
určující	determining
vycházka	outing
výtěžek	yield
zalévat	Water
apoštol	apostle
farmaceutický	pharmaceutical
pekelný	infernal
protestantský	Protestant
stojan	easel
úterní	Tuesday
vzácně	rarely
krmení	feeding
obvodový	peripheral
rozmach	boom
sedmnáctý	seventeenth
steh	stitch
symbolizovat	symbolize
uchránit	protect
vřelý	warm
vyjádřený	expressed
zahřát	warm
bádání	research
jásat	shout
patřičně	accordingly
překročení	crossing
radioaktivní	radioactive
sezení	seating
Texas	Texas
Bulharsko	Bulgaria
dožadovat	crave
MW	MW
náhrobek	tombstone
proslout	proslout
přeběhnout	defect
svlékat	undressing
útroby	bowels
vjezd	entrance
Bruntál	Bruntál
bubeník	drummer
homosexualita	homosexuality
panský	lordly
pohybující	Moving
popřát	wish
průtok	flow
spojující	linking
sporák	cooker
stabilizace	stabilization
toulat	Roam
tvrdost	hardness
civilizovaný	civilized
Dunaj	Danube
křížek	cross
nepřátelství	hostility
parník	steamship
plodina	crop
pojatý	conceived
prodírat	wade through
přestoupit	change
ÚV	CC
Benešov	Benesov
božstvo	deity
Koller	Koller
naštvat	upset
nepříjemnost	unpleasantness
vinit	blame
vyjasnit	clear
zamezit	avoid
Alfa	Alpha
Lenin	Lenin
nejednou	many a time
odvod	conscription
ohniště	fireplace
prohloubit	deepen
prosazování	promotion
semínko	seed
Šárka	Sarka
tabákový	Tobacco
herectví	acting
padák	parachute
ponurý	grim
rozmlouvat	converse
řetízek	chain
severně	north
vyznačit	mark
znázornit	typify
chemik	chemist
kapitalistický	capitalist
kočí	coachman
meditace	Meditation
rodičovský	parental
Thajsko	Thailand
trio	trio
zabručet	grunt
kontinuita	continuity
listopadový	November
ME	ME
pohovor	interview
rozcházet	diverge
spiknutí	conspiracy
US-DEU	US-DEU
zářijový	September
guma	gum
příď	nose
stařenka	grandmother
Sýkora	Sykora
těstovina	pasta
Toronto	Toronto
analogie	analogy
Donald	Donald
homosexuál	gay
muka	anguish
projektant	planner
příplatek	surcharge
shořet	burn
val	wall
vanilkový	vanilla
zatoužit	yearn
zbavený	bereft
dutý	hollow
kráter	crater
sexy	sexy
Zdeňa	Zdeno
zdravotník	medic
exportní	Export
chudinka	poor soul
kožešina	fur
latina	Latin
předposlední	penultimate
Zbyněk	Zbynek
ztroskotat	shipwreck
čepel	blade
doléhat	weigh
družstevní	cooperative
Francisko	Francisco
Franta	Franta
hrávat	have played
létající	flying
plát	slab
povrchní	shallow
překonání	overcome
step	steppe
Tonda	Tonda
demo	demo
nasekat	baste
odborně	professionally
Ukrajinec	Ukrainian
čerpací	pumping
chatrč	shack
koloniální	colonial
kousat	bite
naklánět	tilt
nosnost	capacity
petržel	parsley
salto	somersault
cíp	tip
emigrovat	emigrate
Ch	Ch
kasino	casino
komodita	commodity
navléknout	thread
protein	protein
věru	Indeed
zahnout	turn
fabrika	factory
hadice	hose
severský	northern
střelný	gun
torpédo	torpedo
bankrot	bankruptcy
CIA	CIA
čtveřice	quaternion
Jackson	Jackson
kvetoucí	blooming
polekat	scare
průsmyk	pass
tematický	thematic
vyčkávat	bide
vytočit	dial
vzlétnout	lift off
čekající	waiting
delta	delta
eurozóna	Eurozone
koktejl	cocktail
Lake	Lake
nať	tops
pronásledování	persecution
propouštět	leak
protahovat	protract
přístupový	Access
směsice	mix
všudypřítomný	omnipresent
výtečný	exquisite
zařízený	furnished
potlačovat	to suppress
prso	breast
slibný	promising
unášet	abduct
výměra	acreage
závodit	race
finální	final
koláž	collage
kvantový	Quantum
namluvit	tell
Nancy	Nancy
Nymburk	Nymburk
sazka	sazka
stokrát	hundreds of times
barel	drum
buddhismus	buddhism
civil	civvies
cvik	exercise
dilema	dilemma
progresivní	progressive
rotace	rotation
Selby	Selby
stanovy	statutes
synagoga	Synagogue
vypracování	drawing
autonomie	autonomy
energický	energetic
houf	herd
modř	blue
pokrájet	pokrájet
vystrčit	push out
zaprášený	dusty
beztak	anyhow
Holmes	Holmes
Ján	Ján
návštěvnost	attendance
odemknout	unlock
pakt	pact
Peugeot	Peugeot
přívod	intake
skladový	stock
zjišťování	discovery
country	Country
čilý	alert
fara	rectory
iniciovat	initiate
oplátka	cachet
podnos	tray
poskytnutý	provided
Schweitzer	Schweitzer
šept	Sept
vložka	insert
vousy	beard
automatizace	automation
domeček	house
odliv	outflow
protagonista	protagonist
sebevědomý	self-confident
služebná	maidservant
uživatelský	user
vlídně	graciously
vložený	embedded
výbušnina	explosive
výškový	high-rise
zveřejňovat	published
živnost	trade
Bernard	Bernard
gauč	couch
nezvyklý	unaccustomed
plac	plac
přejíždět	pass over
Stalinův	Stalin
vyčerpávající	exhaustive
zabití	manslaughter
zanechávat	leave
závěť	testament
běžec	runner
čekárna	waiting room
fiktivní	fictive
hnojivo	manure
kooperace	cooperation
motto	motto
pomluva	slander
synovec	nephew
Táňa	Tana
zástavba	development
etiketa	etiquette
jednoduchost	simplicity
krytí	cover
mučení	torture
regenerace	regeneration
sestřenice	cousin
totálně	completely
Bachův	Bach
ex	ex
panák	stooge
pojednou	Suddenly
smysluplný	meaningful
tmavě	Dark
závora	barrier
zdvojnásobit	double
žaludeční	gastric
Berta	Bertha
metro	Metro
Pittsburgh	Pittsburgh
sociologický	sociological
Tvrdík	Tvrdík
úmrtnost	death rate
vichřice	gale
zvířátko	little animal
Igor	Igor
Krkonoše	Mountains
lepit	glue
taktický	tactical
zdůvodnění	justification
atlas	atlas
dekagram	decagram
vnucovat	obtrude
vymyslit	contrive
zavládnout	reign
blokovat	block
Francis	Francis
jídelníček	diet
klasik	classic
liberál	Liberal
Urban	Urban
kalendářní	calendar
odolávat	resist
