pětina	turn
vytratit	accept
panebože	dissolve
kemp	push
koníček	knowledge
posuzování	okay
záclona	wake
Monika	memorial
změněný	confession
odvážet	from beneath
opéci	find oneself
schválený	subscriber
systematický	stay
valašský	funereal
admirál	revival
fakticky	pride
farmář	decree
nakládání	external
počínání	seeing
Poirot	publisher
rozchod	improving
spěch	burning
vycítit	impress
da	Open
norský	echo
vypsat	developed
důchodový	flood
Irsko	explore
preference	record
krejčí	steak
kontrast	thesis
neklid	expel
zacházení	called
Fischer	Portugal
kulisa	noble
rozplakat	Ben
roztomilý	captivate
úmyslně	fill
velvyslanectví	tobacco
předejít	odor
překračovat	Strongholds
analytický	Bone
průčelí	quietly
tříletý	exclusion
záchranář	prohibited
demonstrovat	it
komorní	drum
postihovat	Korea
působivý	Mooshabrová
chemie	cloakroom
nákaza	obviousness
spolknout	shelter
stejnojmenný	trifle
be	payment
potopit	criminologist
Rakušan	atomic
reprodukce	farmer
set	mix in
dámský	double
chopit	mile
obviňovat	Alice
sláma	grenade
vesmírný	oil
zlost	element
náročnost	nationwide
odlišnost	value
svatyně	offered
Colin	remedy
pohroma	prime
pracovnice	delegation
razítko	engage
sklizeň	throw
zpozorovat	richly
statický	rat
úd	lessons
vcházet	Greek
dělnický	Navy
mariánský	marked
oslovovat	heart attack
překvapovat	moderator
vzrušující	boredom
podvodník	allocate
svázat	hull
žláza	urge
ostuda	destruction
remíza	Jack
veřejnoprávní	truck
instinkt	God
milosrdný	weekly
povzbudit	shame
splést	In any event,
ustat	deep
jamka	give up
schvalovat	FMV
vloupat	reconstruction
citron	shift
cola	enabling
fúze	verdict
napovídat	Attract
poskytnutí	cleaning
vtipný	toxic
zesílit	Louis
biblický	Republic
libovolný	Finnish
potlesk	expressly
ubránit	dignity
zdravotně	door
hodinový	overlook
chodidlo	rock
otáčka	academic
rvát	operate
seriózní	growth
Šumava	dried
vybavovat	Dagmar
efektivně	der
exploze	image
Miloslav	alive
opona	distinction
pobavit	windy
vzpoura	Venice
Finsko	street
kandidovat	Tereza
lázeňský	roll
rozšiřování	deal
špína	amateurish
urážka	Cheb
veselí	insurance
zábrana	download
začínající	lol
ahoj	conversion
bitevní	shock
hostina	form
nábřeží	criminality
navržený	knowledge
popředí	faithfulness
prováděný	wrinkle
ručně	remote
vládnoucí	Indian
cibulka	lantern
památkový	gracefulness
mísit	forgotten
pyramida	residence
tamhle	deviation
vyčíst	fault
pentlička	jacket
přemoci	compulsory
spekulovat	olive
střešní	salesman
širý	therapeutic
úsudek	left
obývat	hold up
vyvinutý	resistant
zabývající	above
moskevský	reproach
prdel	occupy
rýsovat	from without
sloučenina	Danish
vír	pregnant
dotčený	wave
pobíhat	suspenders
zapamatovat	valorize
agenda	submit
českobudějovický	surgery
dub	tin
Gustav	release
dražba	foil
volnost	Lenka
pocházející	sprout
antibiotikum	banking
hostinský	apology
ukradnout	hall
červ	raw
Írán	arrow
můra	in theory
skóre	negative
spolehlivě	dairy
vízum	Cup
zdvořile	early
zvětšovat	cast
adaptace	desolate
carský	Bean
doběhnout	bore
Martina	give out
ústí	structural
Web	symptomatic
zátoka	dole out
freska	Heating
Andrew	fly out
extáze	Coalition
génius	sight
krach	fish
cirkus	assortment
poprava	glacier
střetnutí	Madrid
brečet	inquire
dovézt	opera
knedlík	third
Kosovo	serving
obecenstvo	Capturing
úspěšnost	violin
balet	Not only
nepřetržitý	kindly
obnovení	Sigh
party	outbalance
ušklíbnout	command
utkat	cope
autorův	franc
Diana	fulfillment
gang	match
předsednictvo	kindergarten
rozličný	show
spotřebitelský	slow down
tupý	pit
útočiště	Clare
Alex	passage
loutka	boulder
mizerný	German
zneužití	shower
křoví	admission
Lada	mutter
Třebíč	owe
úděl	interaction
atlantik	operative
baterka	come in
distributor	install
shromažďovat	subordinate
svařování	waived
Dan	surrounding
mandle	Putin
papoušek	shady
vděčit	completed
dvanáctý	Chrudim
kufřík	cylinder
poskytovatel	C
prasknout	defense
středoevropský	thin
svit	yesterday
troufat	remove
Boston	driving
konkursní	consistently
přeměnit	cover
senior	call
čtvrť	Zizkov
kachna	authorization
prorazit	soil
sklonek	terrestrial
nabitý	flower
přepočet	Fisheries
Walter	panic
epizoda	contend
Hans	flow
hrubě	punish
chybějící	coating
malířství	chauffeur
Florida	native
cosinus	to fight
projekce	escort
předsedkyně	Friday
uveřejnit	Maria
kopnout	link
hostitel	dimness
Ježíšův	expense
jizva	Paradoxically,
Kavan	applicable
nevyhnutelný	release
severočeský	surprise
turbína	amplifier
vyučovat	can
zdali	tiger
Freud	Holding
metropole	cramp
nadaný	kW
odezva	side
předčasně	secular
svěřenec	Dutch
vylepšit	earnings
dramatik	Occur
hon	earthquake
lepidlo	bus
reaktor	excel
světec	go down
tancovat	dynamics
výtvor	bitter
y	breeding
ponožka	glisten
spása	alternately
domněnka	radiant
laser	holding
kapitalismus	especially
předák	harmony
Sázava	skis
sběratel	coming
ústup	říkávat
zhoršit	Sarah
osvědčený	harm
ples	Mahler
přísada	secondary
vystavený	story
smyčka	ie
evangelium	consider
hlučný	girl
Vlasta	exhibit
zítřek	eat
bystrý	Argentine
mor	carrier
page	interpret
sjezdovka	combine
široce	Larch
přestup	shrill
reflektor	take over
rezignovat	persuading
zachvět	realistic
Andrea	fur
kandidátka	sensitivity
pochlubit	homeboy
rozmyslet	Brown
srdečně	irony
com	Beseda
návyk	physics
rozdat	surely
korporace	reading
narovnat	Head
přeskočit	diet
střežit	DNA
žalobce	breathe
posel	consort
rub	paycheck
říční	brake
zorganizovat	veranda
Bohuslav	reject
dvorní	or
hraní	power
injekce	note
malířský	analogy
nadrobno	synoptic
parní	historically
Sydney	mathematics
účes	prose
zesnulý	learning
Slovan	sicken
Clay	come
expanze	fox
matematický	revelation
orel	department
pohltit	take off
posedlý	shorten
řev	twilight
celoživotní	Training
enzym	temporarily
konvence	photographic
poschodí	protect
vesnický	consolation
Windows	bull
zamračit	Nathan
jiskra	boring
Terry	grated
uhodit	check
vyzařovat	density
zbavovat	illustration
partnerka	masterful
porodit	graduate
promítnout	keep
přihláška	sheen
statut	betrayal
zareagovat	exotic
zvětšit	tear
kolektiv	Sustainable
poražený	animal
propad	grind
utřít	contemporary
hojně	implementation
pozitivně	contained
víkendový	Saddam
přilba	briny
spalování	mud
vyčerpaný	Miner
bílek	Oscar
eventuální	hot
vymazat	purchase
exil	always
podstoupit	figures
součet	Reuter
účinně	fixedly
vychovat	handful
letectvo	collection
rozdělený	handy
vyslovovat	educate
džbán	insurrection
hrom	fleeing
vesnička	William
zřetel	housing
ilustrovat	repetition
kouknout	section
porušování	Stephanie
svítání	ahead
šachta	cause
zradit	Christ
brutální	cook
ekonomie	reimburse
formace	replete
kytice	citizenship
podivuhodný	clutch
studna	watch for
ošetření	prank
Procházka	Accompanying
titulní	command
uklidňovat	affiliation
indikátor	reportage
jihlavský	break up
zahradník	text
chlubit	rabbi
kapr	waterfall
Adolf	demarcation
bouřka	contact
dostupnost	decorate
nahlížet	Pochvalov
navrhovaný	recipient
badatel	fighter
Litvínov	shock
partnerský	result
propaganda	smoking
prostitutka	Retirement
třicetiletý	fail
užívaný	bold
hospodařit	bid
kovář	Norway
kriminální	cucumber
pitný	vessel
pokrývka	think
kdekdo	commended
schodek	thirst
dohnat	footpath
Jičín	sensual
jihomoravský	blaze
soustředěný	eye
Milán	witness
stolní	experience
ghetto	Technically
návaznost	taxation
pospíšit	Muslim
příznivě	benefit
vyletět	lard
bosý	neighborhood
Cyril	married
jas	contract
pumpa	tighten
savec	destroyer
vévodkyně	negotiation
Jones	witch
nesmyslný	Chinese
obstarat	Serbian
postávat	live
kladivo	premium
podobnost	void
archeologický	close up
Charlie	check
Padraik	race
rajský	ebb
zeleninový	define
autentický	formally
displej	partnership
dodatečně	plea
dýmka	nature
Havířov	instinct
pól	Engineering
přehodit	seriousness
sjednocení	icon
útočný	Music
intervence	raise
konfrontace	charter
ztuhnout	department
živě	revealing
borovice	lit.
dospělost	suburb
očištěný	organ
textilní	leftist
trofej	schedule
vrtět	Catholic
plodný	pension
prodlužovat	conditioned
zdravit	profit
letadlový	Bohumil
Otakar	beat
poučení	identity
HTTP	prohibit
Chris	from the inside
navenek	convicted
novodobý	spider
úroda	supervise
zmlknout	fool
hejno	ceramic
překvapený	reduction
HN	helpless
nechť	waiting
postřehnout	motorcycle
zdobený	send
Arthur	Sona
odklad	psychiatrist
překrásný	nictate
přepadení	circumvent
přetrvávat	pointing
uměle	detected
vázaný	clean
ala	across
bolestivý	compare
doplnění	Competition
krytý	copy
lom	bullet
povlak	saving
CSc	aging
hej	negligible
intenzivně	des
nepatrný	peculiarly
stromek	motional
tanečník	anticipate
cent	added
geniální	penetrate
humanitární	gleam
chystaný	inclusion
kotouč	epidemic
nervózně	lecture
trám	supermarket
Yossarian	consciously
Alois	flowerbed
bohoslužba	crash
impérium	j
lyžař	microphone
mexický	youthful
vyvrcholit	describe
citovaný	hare
dna	stupid
Lubomír	mainland
maličko	nineteenth
svěřovat	hook
zadání	auditorium
zneužívání	grove
ježek	intimate
jogurt	towel
přikrývka	pluck
tribuna	bookkeeping
Steve	electron
šampaňské	purchasing
zvířecí	motivate
berlínský	rejection
editor	wold
negativně	temptation
peří	shelf
šlechtický	predilection
toaleta	Hradec
zaregistrovat	correspondence
zářící	advisory
aktér	solid
lékárna	developed
Líza	Baghdad
bank	cousin
cestička	hillside
izolovaný	structural
okenní	cooking
únos	circumscribed
ideologický	Package
Island	touch
konverzace	earthly
obohatit	prophet
připisovat	complicate
strážný	shake
zhodnocení	Ellen
galaxie	rubber
Hamburk	goodbye
harmonický	descend
známá	fix
administrativa	wheeler
chlapeček	simmer
svolat	acquaintance
upéci	cross
ústní	collar
zjevit	married
figurka	ethnic
hodnost	violet
klubový	occupation
maturita	repair
naráz	sail
nepřetržitě	Prostejov
syntéza	Falcon
marihuana	Warsaw
rozklad	conductor
tarif	lodge
vysadit	resist
bližní	exhibition grounds
klenba	pepper
nastěhovat	Drawing
sypat	sun
ubytovat	thousand
výpadek	cellular
ráčit	house
United	bosom
krvácení	adjustment
spící	p
symfonie	pastry
vous	object
hrací	report
jahoda	cover
koryto	deal
osudový	panel
bezesporu	weary
pražan	quantity
přepážka	pearl
přiběhnout	Rental
topit	Philosophical
upírat	hungry
Gott	let alone
klouzat	Zdena
projektový	efficiency
průběžný	jazz
vyměňovat	magazine
zamlouvat	stand
zmenšit	Yuan
žárovka	Pavilion
dírka	fall
e-mail	seen
rozlišit	living
vyjíždět	excessive
Wolf	dew
podpůrný	nobility
vyhodnocení	You're welcome
Bedřich	dependently
francouzština	unexpected
magie	convincing
životopis	stare
ad	old
FBI	nationality
formovat	lot
jmenování	revenge
komický	refer
zakotvit	Profitable
los	activist
MUDr	native
produktivní	goose
respondent	chopped
sklízet	semester
vězet	crushing
čekaný	robbery
Eddie	student
odškodnění	measure
radikál	surgical
mentální	advanced
nasednout	restructuring
přírůstek	finish
vtrhnout	canalization
Alžběta	Nazi
dokumentovat	notebook
šelma	rock
koupání	membrane
letenka	magazine
nepořádek	fluid
neschopnost	German
překonávat	rent
ptáček	steep
solidarita	spoil
škodovka	stir
uhelný	tribute
exemplář	jumper
sanitka	schoolboy
střízlivý	nursemaid
urychlit	Secretary
reál	Nedvěd
ukrajinský	giant
dál	register
fascinovat	column
ječet	paradox
likvidovat	four
příjmení	smoothly
spolehnout	tinny
tkvít	biennial
zklamaný	bookshelf
elitní	cohabitation
nádhera	knock
nadnárodní	optimism
ničení	Play
rámeček	Bach
kontroverzní	booth
odvolávat	carry
hrdost	turn out
Charlotte	hn
infekční	hunting
označovaný	headquarters
bankéř	fiscal
km/h	reverse
monitor	procrastinate
Nisa	move
výloha	exaggerated
diagnostika	jerk
mrazivý	facilitate
patřící	bee
Přerov	Anderson
šíje	BBC
zničení	cruiser
hromádka	breathing
Iva	flyer
pásek	butterfly
pěvecký	attachments
radostně	leveling
střetnout	Brazil
pečený	defined
převyšovat	yard
vertikální	Oliver
hlaveň	wonder
oslavovat	rum
poskytovaný	semifinal
rozpuštěný	Ivana
závoj	Professional
dobrota	convinced
kohoutek	sleep
odvíjet	asylum
pahorek	rush
pětiletý	Renaissance
pomeranč	pluck
čajový	burn
hodnotný	frontal
obhájit	familiarly
opěradlo	globalization
podplukovník	appreciate
vlek	slither
časně	functional
minerální	whore
dcerka	occasional
ekologie	time
Jake	blanket
preparát	equine
šroub	buyer
zapisovat	Deputy Mayor
monarchie	dedicated
skotský	weaken
vodka	wipe
zbožný	seen
zveřejnění	space
zpracovaný	revolver
fakultní	wave
materiálový	painful
Philip	peninsula
slabě	ES
Dean	from here
hypotéka	election
svalový	subtract
sdělovací	pensively
hierarchie	Indian
Jacques	greasy
kašel	rouge
obrábění	consolidate
opáčit	congenital
žal	Gravitational
doleva	Barracks
Kroměříž	clothe
křiknout	writing
monopol	Wells
osmahnout	flu
pejsek	tenant
Peking	build
projednávat	comfort
spisovatelka	zoological
vodík	registered
diskotéka	taxpayer
dlouze	Regulatory
hospodin	bill
svobodně	total
tyčit	army
vyučovací	throb
bin	IMF
odborář	bathe
perfektní	revive
proměňovat	prison
sežrat	captivity
stud	brickwork
zajištěný	huť
jazzový	parsley
odstraňování	pulmonary
otrava	flood
pacientka	attraction
telefonát	donor
výroční	element
zlehka	near
oloupaný	terminal
průběžně	ladder
socialista	colleague
svislý	dot
špitál	discourage
uklízet	Wenceslaus
vyšetřovací	frightened
arab	compulsion
blaho	fiery
clo	orange
okrajový	hide
uspokojivý	stir
banán	supply
kronika	drown
namáhat	proclaim
plynoucí	Stanley
prodavačka	cringe
Španěl	separate
ubývat	bankruptcy
zdolat	recede
dědek	fee
kocour	tear off
konkurovat	Dana
monsieur	consistent
natažený	Microsoft
odseknout	trash
splývat	synek
Tokyo	inherit
Vietnam	coffee
zažívat	wreak
Duun	enter
majitelka	acquisition
paměti	wail
stoupající	editor in chief
svézt	employed
veronika	Hollywood
Dukla	USSR
překládat	lens
rampa	plastic
spontánní	resort
usilovně	exclusively
členění	achieved
hle	Grape
poradenství	hospital
protilátka	Cup
provozování	entertain
příčný	massive
sloh	show
tíseň	blurt
věnec	feed
tanečnice	petition
Art	preventive
fyziologický	Allied
nahrát	neutral
povstat	put off
přebytek	ask
vysoká	bet
vystačit	potato
zdání	Cadfael
dodatek	paving
prostěradlo	ticket
registr	Palestinian
sbalit	passenger
vodovod	bag
bulvár	excuse
delegát	conventional
JUDr	refer
potravinářský	telegram
bezvýznamný	vexation
hospodyně	Licensing
madame	experimental
odstrčit	I wish
Ralph	Hurt
sprostý	sitting
sváteční	conclude
vypočítat	argentina
bezdomovec	limpid
bloudit	photograph
černá	mystical
emigrace	peel
narážka	sensory
penalta	market
prvenství	class
rozptýlit	argue
zatčení	prescribed
zuřit	builder
podepsaný	Hasek
rota	invasion
skýtat	southeast
stékat	meet
desetiletý	go through
hasičský	benign
představivost	linear
teritorium	fleet
zpochybňovat	exasperate
jeřáb	broken
nezaměstnaný	active
opat	fairytale
stýskat	orderly
brácha	ISO
nadvláda	passive
párkrát	Vojtech
starobylý	wildly
Petrohrad	surgeon
riskantní	machining
samička	counterpart
soutěžit	deal
Třinec	immeasurable
leasingový	handbook
útlý	demon
člověče	dwarf
Grand	culprit
stařena	subsidiary
vyhledávání	virgin forest
zápasit	reporter
náramně	mortar
ošetřit	Mercedes
přízrak	solemnly
vyvádět	hearing
zatraceně	jungle
nacpat	deer
poctivě	Sand
prací	permissible
příslib	pollution
žebro	circle
kazeta	hugging
křest	Otto
mělký	awareness
perspektivní	ace
vhodně	dwelling
Vít	half
vyvážený	status
lítat	store
mg	relieve
puberta	Decin
původce	classification
smělý	winning
smést	bind
ukradený	Agnes
vydávání	pour
céva	nickname
horník	virtue
inkasovat	many things
kompaktní	renowned
Lin	Member
Milada	how much
přenosný	lowly
struna	sup
vinice	enumeration
zasvětit	praise
časoprostor	basket
doplatit	evacuate
napodobovat	fatal
přesvědčivě	slowly
románský	tourism
zpáteční	goddess
žába	clean
dokořán	chest
přitažlivost	enthusiastically
staroměstský	tenderly
bombardér	value
gram	suggest
hadr	caution
off	discuss
topení	adjacent
uvíznout	run
Cikán	Znojmo
kazit	specialty
nalezený	inn
písečný	understanding
specialita	carriage
batoh	Muslim
mýdlo	clean up
předsudek	wrong
rovnice	onslaught
stanovovat	possessive
bič	buyer
metodika	convention
spotřebovat	bed
SRN	pattern
dvacetiletý	communion
konzerva	lagoon
Maďar	miss
praktika	void
softwarový	tempt
blahý	emphatically
diamant	advocate
kamení	perfume
napomáhat	careful
terénní	craftsman
zemanův	emerge again
kurt	allowable
páka	draw
pojmenování	tread
sejmout	Pressure
sestřička	cigar
tepna	say goodbye
úpatí	Network
vidina	ongoing
vzrušený	nineteen
levně	Until recently,
miniaturní	concert
otisknout	repayment
povzbuzovat	shy
psychiatrický	outdoor
Hugo	Cholesterol
osobitý	tie
sílit	procedure
švagr	veteran
dechový	customs officer
lahvička	Yugoslav
nika	sequence
hrůzný	Smith
pozdravovat	revelation
hlídač	no way
Michel	barn
odcizit	clove
pozorný	twenty-four
Xenie	Edita
otrávit	coordination
	a fifth
	disappear
	Oh my God
	camp
	hobby
	assessment
	curtain
	Monika
	changed
	collect
	fry
	approved
	systematic
	valašský
	admiral
	factually
	farmer
	loading
	conduct
	Poirot
	gauge
	rush
	feel
	da
	Norwegian
	list
	retirement
	Ireland
	Preferences
	tailor
	contrast
	unrest
	treatment
	Fischer
	scenery
	make cry
	cute
	deliberately
	embassy
	prevent
	exceed
	analytical
	frontage
	three-year
	Rescuer
	demonstrate
	Chamber
	affect
	impressive
	chemistry
	infection
	swallow
	homonymous
	Be
	sink
	Austrian
	reproduction
	set
	lady's
	seize
	blame
	straw
	cosmic
	anger
	sophistication
	distinction
	shrine
	Colin
	disaster
	employee
	stamp
	harvest
	spot
	static
	limb
	to enter
	Workers'
	Marian
	address
	surprise
	exciting
	trickster
	tie
	gland
	shocker
	draw
	public
	instinct
	merciful
	encourage
	confuse
	surcease
	hole
	approve
	burgle
	Lemon
	cola
	merger
	prompt
	provision
	witty
	intensify
	biblical
	arbitrary
	applause
	help
	health
	hourly
	foot
	revolution
	rend
	serious
	Šumava
	Outfitting
	effectively
	explosion
	Miloslav
	curtain
	entertain
	insurgency
	Finland
	run
	Spa
	expansion
	dirt
	insult
	cheerfulness
	barrier
	beginning
	Hello
	Battleship
	feast
	embankment
	designed by
	foreground
	conducted
	Manually
	ruling
	bulb
	Heritage
	mix
	pyramid
	there
	read
	ribbons
	overwhelm
	speculate
	Roof
	expansive
	opinion
	inhabit
	developed
	dealing
	Muscovite
	ass
	draw
	compound
	swirl
	issue
	run about
	remember
	Agenda
	Budweis
	oak
	Gustav
	auction
	freedom
	coming
	antibiotic
	innkeeper
	steal
	worm
	Iran
	Nightmare
	score
	reliably
	visa
	courteously
	increasing
	adaptation
	Czarist
	bamboozle
	Martina
	mouth
	Web
	cove
	fresco
	Andrew
	ecstasy
	genius
	crash
	circus
	execution
	engagement
	weep
	deliver
	dumpling
	Kosovo
	audience
	success
	ballet
	continuous
	restoration
	party
	grin
	fight
	the author
	Diana
	gang
	Bureau
	sundry
	consumer
	edgeless
	haven
	Alex
	puppet
	crappy
	abuse
	bushes
	Lada
	Třebíč
	lot
	Atlantic
	flashlight
	distributor
	Collect
	welding
	Dan
	almonds
	parrot
	owe
	twelfth
	case
	provider
	crack
	Central Europe
	shine
	dare
	Boston
	Bankruptcy
	convert
	senior
	district
	duck
	break through
	close
	loaded
	conversion
	Walter
	episode
	Hans
	roughly
	missing
	painting
	Florida
	cosine
	Projection
	chairwoman
	publish
	kick
	host
	Jesus'
	scar
	Kavan
	inevitable
	North Bohemia
	turbine
	teach
	whether
	Freud
	metropolis
	gifted
	response
	early
	ward
	upgrade
	playwright
	hunt
	glue
	reactor
	saint
	dance
	creation
	y
	sock
	salvation
	assumption
	laser
	capitalism
	foreman
	Sázava
	collector
	retreat
	worsen
	experienced
	ball
	additive
	exposed
	loop
	gospel
	noisy
	Vlasta
	tomorrow
	bright
	plague
	page
	downhill course
	widely
	transfer
	spotlight
	resign
	shiver
	Andrea
	candidate
	features
	think about
	heartily
	com
	habit
	give away
	corporation
	straighten
	skip
	guard
	prosecutor
	messenger
	reverse
	fluvial
	organize
	Bohuslav
	court
	Play
	injection
	pictorial
	Finely
	steam
	Sydney
	hairstyle
	deceased
	Slav
	Clay
	expansion
	mathematical
	eagle
	swallow
	hooked
	roar
	lifelong
	enzyme
	convention
	storey
	country
	Windows
	overcast
	sparkle
	Terry
	hit
	irradiate
	get rid of
	Partner
	give birth
	projected
	application
	statute
	react
	enlarge
	team
	defeated
	Drawdown
	wipe
	profusely
	positively
	weekend
	Helmet
	combustion
	exhausted
	albumen
	eventual
	delete
	exile
	undergo
	sum
	effectively
	bring up
	air force
	divided
	pronounce
	pitcher
	thunder
	hamlet
	consideration
	illustrate
	peek
	violations
	sunrise
	shaft
	betray
	brutal
	economics
	formation
	bouquet
	prodigious
	well
	treatment
	Stroll
	title
	easing
	indicator
	Jihlava
	gardener
	flaunt
	carp
	Adolf
	storm
	availability
	inspect
	proposed
	researcher
	Litvínov
	Affiliate
	propaganda
	prostitute
	thirty
	used
	farm
	smith
	criminal
	drinking
	cover
	Everybody
	deficit
	catch up
	Jicin
	South Moravian
	intent
	Milan
	table
	ghetto
	continuity
	hurry
	favorably
	fly out
	barefoot
	Cyril
	brightness
	pump
	mammal
	duchess
	Jones
	pointless
	purchase
	hang around
	hammer
	similarity
	archaeological
	Charlie
	Padraik
	tomato
	vegetable
	authentic
	Screen
	additionally
	pipe
	Havirov
	pole
	throw
	unification
	offensive
	intervention
	confrontation
	congeal
	Live
	pine
	adulthood
	refined
	textile
	trophy
	wiggle
	fruitful
	extend
	salute
	Airplane
	Otakar
	enlightenment
	HTTP
	Chris
	externally
	modern
	crop
	shut up
	covey
	surprised
	HN
	let
	espy
	decorated
	Arthur
	reprieve
	beautiful
	assault
	persist
	artificially
	bound
	ala
	painful
	completion
	indoor
	quarry
	coating
	Ph.D.
	hey
	heavily
	slight
	sapling
	dancer
	cent
	brilliant
	humanitarian
	forthcoming
	disc
	nervously
	beam
	Yossarian
	Alois
	worship
	empire
	skier
	Mexican
	climax
	cited
	gout
	Lubomír
	little
	confide
	task
	abuse
	hedgehog
	yogurt
	blanket
	tribune
	Steve
	Champagne
	animal
	Berlin
	editor
	negative
	feather
	noble
	toilet
	register
	gleaming
	actor
	pharmacy
	Lisa
	Banks
	path
	isolated
	window
	kidnapping
	ideological
	Iceland
	conversation
	enrich
	attributable
	guard
	appreciation
	galaxy
	Hamburg
	harmonious
	known
	administration
	baby boy
	convene
	bake
	oral
	reveal
	figurine
	rank
	club
	graduation
	at once
	continuously
	synthesis
	marijuana
	decomposition
	tariff
	land
	neighbor
	vault
	move
	strew
	house
	failure
	vouchsafe
	United
	hemorrhage
	asleep
	symphony
	hair
	playing
	strawberry
	trough
	fatal
	indisputably
	Pražan
	partition
	run up
	stoke
	denied
	Gott
	slide
	Project
	running
	exchange
	liking
	shrink
	bulb
	hole
	E-mail address
	distinguish
	drive out
	Wolf
	Support
	evaluation
	Bedrich
	French
	magic
	resume
	ad
	FBI
	shape
	appointment
	comic
	anchor
	moose
	MD
	Productive
	respondent
	harvest
	inhere
	waiting
	Eddie
	compensation
	radical
	mental
	remount
	growth
	invade
	Elizabeth
	document
	beast
	bathing
	ticket
	mess
	inability
	overcome
	bird
	solidarity
	Skoda
	coal
	specimen
	ambulance
	sober
	accelerate
	real
	Ukrainian
	farther
	fascinate
	yell
	liquidate
	surname
	count
	consist in
	disappointed
	crack
	finery
	multinational
	destruction
	border
	controversial
	recall
	pride
	Charlotte
	infectious
	called
	banker
	km / h
	monitor
	Nisa
	shop window
	diagnostics
	frosty
	belonging
	Prerov
	is
	destruction
	pile
	Iva
	strap
	Singing
	gleefully
	clash
	baked
	exceed
	vertical
	barrel
	celebrate
	provided
	Dissolved
	veil
	goodness
	withers
	unfold
	knoll
	five-year
	orange
	tea
	valuable
	uphold
	armrest
	lieutenant colonel
	tow
	early
	mineral
	daughter
	ecology
	Jake
	preparation
	bolt
	enter
	monarchy
	Scottish
	vodka
	pious
	disclosure
	processed
	faculty
	Material
	Philip
	faintly
	Dean
	mortgage
	Muscle
	Communication
	hierarchy
	Jacques
	cough
	machining
	Opacity
	heartbreak
	to the left
	Kroměříž
	shout
	monopoly
	Brown
	doggie
	Beijing
	discuss
	authoress
	hydrogen
	discotheque
	long
	LORD
	freely
	rear
	teaching
	bin
	odborář
	perfect
	transform
	devour
	shame
	catered
	jazz
	removal
	poisoning
	patient
	phone call
	annual
	gently
	hulled
	regularly
	socialist
	vertical
	hospital
	clean up
	Investigation
	Arab
	welfare
	duty
	marginal
	satisfactory
	banana
	chronicle
	strain
	flowing
	saleswoman
	Spaniard
	wane
	overpower
	dědek
	tomcat
	compete
	Monsieur
	taut
	retort
	merge
	Tokyo
	Vietnam
	experience
	Duun
	proprietress
	memoirs
	rising
	ride
	veronika
	Dukla
	translate
	ramp
	spontaneous
	hard
	division
	lo
	counseling
	antibody
	operation
	transverse
	style
	distress
	wreath
	dancer
	Art
	physiological
	record
	rise
	surplus
	High
	scrape by
	appearance
	supplement
	sheet
	register
	pack
	water supply
	boulevard
	delegate
	JUDr
	Food
	meaningless
	housekeeper
	Madame
	push
	Ralph
	indecent
	Festive
	calculate
	homeless
	wander
	black
	emigration
	cue
	penalty
	primacy
	dispel
	arrest
	rage
	signed
	company
	rendering
	flow down
	ten
	fire
	imagination
	territory
	question
	crane
	unemployed
	abbot
	homesick
	brother
	domination
	a few times
	ancient
	Saint Petersburg
	risky
	female
	compete
	Trinec
	leasing
	slender
	man
	Grand
	old woman
	search
	wrestle
	enormously
	treat
	wraith
	carry on
	damn
	>
	czech.txt
	;
	cram
	honestly
	wash
	promise
	rib
	cassette
	baptism
	shallow
	perspective
	appropriately
	Bind
	balanced
	flying
	mg
	puberty
	originator
	bold
	brush off
	stolen
	publishing
	blood-vessel
	miner
	cash
	compact
	Lin
	Milada
	portable
	string
	vineyard
	consecrate
	spacetime
	pay
	imitate
	convincingly
	Romance
	return
	frog
	wide open
	attraction
	Old Town
	bomber
	gram
	rag
	off
	heating
	jam
	Gypsy
	spoil
	found
	sandy
	specialty
	backpack
	soap
	bias
	equation
	set
	whip
	methodics
	consume
	Germany
	twenty
	tin
	Hungarian
	practice
	Software
	Blah
	diamond
	rocks
	assist
	landscaping
	Zeman
	court
	lever
	designation
	remove
	nurse
	artery
	foot
	vision
	excited
	cheaply
	miniature
	print
	invite
	psychiatric
	Hugo
	distinctive
	grow
	brother in law
	woodwind
	phial
	Niche
	creepy
	acclaim
	watchman
	Michel
	alienate
	attentive
	Xenia
	poison
