a	the
meg	to
vagy, van, vagyok, vannak, vagytok	or there, I'm there, you are
volt	It was
már	already
kell	must
még	yet
és	and
mint	as
azt, az	it is
akkor	then
sem	neither
lehet	may
mert	because
minden	all
olyan	so
szerint	according to
pedig	in turn
ezt, ez	this is
így	so
után	after
úgy	so
nagy	great
fel	up
majd	then
két	two
nem	no
nagyon	very
aki, akik, akit, kit, kik	who, who, who, who, who
most	now
több	more
lesz	will be
itt	here
magyar	Hungarian
ami, amik, amit, mit	is that what what
első	first
között	between
amely	which
hanem	but also
nincs	no
más	other
illetve	and
alatt	below
egyik	one
volna	have
arra	to
kft.	ltd.
ilyen	such
azonban	but
sok	lot
való	to
által	by
amikor	when
számára	for
valamint	as well as
azért	therefore
egy	one
saját	own
jól	well
ember	human
ahol	where
ott	there
annak	to
mindig	always
miatt	for
mellett	next to
kis	little
alapján	Based on
lenne	It would be
előtt	before
egész	whole
nélkül	without
lett	became
ezért	therefore
igen	yes
másik	other
stb.	etc
teljes	complete
néhány	some
során	In
ma	today
hiszen	because
milyen	what
mely	deep
mind	all
valami	something
viszont	however
áll	stand
tehát	Therefore,
inkább	rather
legyen	whether
három	three
tudom	I know
amelyek	which
éves	years old
ezek	these
adott	given
nagyobb	bigger
például	for example
szükséges	necessary
együtt	together
azok	they
akár	will
tovább	further
ennek	for this
nekem	me
megfelelő	appropriate
őket	them
szó	word
elég	enough
hozzá	him
erre	this
neki	him
ezzel	with this
következő	next
esetén	In case of
mivel	because
ezen	this
belül	within
éppen	just
közül	Among
fontos	important
jobb	right
benne	in it
magát	herself
esetben	event
talán	maybe
különböző	different
voltak	They were
fog	tooth
teljesen	completely
maga	itself
rendszer	system
nap	day
egyes	single
található	found
vele	with him
ebben	in this
kellett	I had
második	second
túl	too
minden	all
egyre	ever
csak	only
arról	about
valaki	someone
ennek	for this
óta	since
emberek	people
egyéb	other
ahogy	as
semmi	nothing
tudja	you know
azzal	with
ugyanis	namely
került	It was
ellen	against
mondta	He told
miért	why
aztán	then
című	on
kicsit	a bit
módon	way
vissza	back
bár	bar
világ	world
abban	therein
legnagyobb	greatest
legalább	at least
mindenki	everyone
jelent	mean
újra	again
persze	of course
részt	part
tud	can
kívül	outside
eddig	so far
most	now
össze	together
keresztül	through
biztos	commissioner
utolsó	last
isten	God
idő	time
azon	is your
itt	here
kerül	cost
szinte	almost
egyetlen	single
dolog	thing
szép	beautiful
mikor	when
mégis	yet
érdekében	To
felé	to
mai	modern
szemben	against
sokkal	much
jog	law
hogyan	how
összes	all
gazdasági	economic
ide	here
nemzetközi	international
szerintem	I think
míg	while
további	further
képes	able
szakmai	professional
legjobb	best
így	so
amelyet	which
általában	usually
újabb	another
évi	yearly
szóló	solo
tovább	further
kellene	should
hosszú	long
kapcsolatban	connection
helyi	local
jobban	more
politikai	political
kapcsolatos	related
régi	old
ezek	these
cég	company
szabad	free
egyszer	once
része	part
azokat	those
emberi	human
teszi	makes
készült	made
számos	several
közös	common
sikerült	succeeded
rossz	bad
közben	during
hasonló	similar
lévő	in
hazai	home
törvény	law
történt	occurred
segítségével	help
száma	The number
élet	life
kapott	got
igaz	true
mindent	everything
esetleg	maybe
még	yet
külön	separately
oldal	page
bizonyos	some
végén	At the end of
Budapest	Budapest
történő	to
elő	live
amerikai	American
jelentős	significant
angol	English
évben	year
vonatkozó	concerning
álló	standing
elsősorban	primarily
ország	country
jelenleg	currently
többi	other
jelenleg	currently
alá	below
európai	European
vagyunk	we're
négy	four
szükség	need
természetesen	naturally
éve	Year
évek	years
hát	back
film	movie
melyek	which
azaz	namely
megy	go
magas	high
elmúlt	past
lehetséges	possible
pár	par
sőt	moreover
amelynek	which
szintén	also
általános	general
csupán	only
igazán	really
német	German
esetében	for
mintha	as if
később	later
igazi	real
először	first
nemcsak	not only
ahhoz	thereto
ellenére	despite
has	stomach
korábban	earlier
fél	party
október	October
közötti	between
sokat	lot
jelenti	means
város	city
belső	internal
regisztrált	registered
ismét	again
mert	because
nagyon	very
társadalmi	social
harmadik	third
pont	point
egyébként	otherwise
fenntartva	Reserved
kérdés	issue
kormány	government
Péter	Peter
kisebb	less
már	already
tényleg	really
eredeti	original
addig	before
helyen	location
annyira	so much
lehetőség	possibility
oldalon	website
munka	work
voltam	I've
óra	watch
hol	where
helyett	instead of
úgy	so
valóban	really
érdemes	worth
soha	never
vált	change
senki	no one
tenni	do
rövid	short
melyet	by
hiszem	I believe
mondja	says
lehetett	could
megfelelően	properly
lehetőséget	option
létre	created
lenni	to be
jött	came
valamit	something
ezért	therefore
férfi	man
hát	back
mintegy	like a
ezeket	these
tett	deed
közel	close
egyszerű	simple
hét	seven
egészen	quite
sor	line
szerintem	I think
korábbi	former
utóbbi	latter
adatok	Data
linux	linux
gyakran	often
követően	Following
kép	picture
nehéz	difficult
ugyan	though
rajta	on
venni	consideration
amikor	when
meghatározott	specified
akar	will
lehetővé	possible
tagja	Member
hat	six
tudok	I can
melynek	with
este	evening
felhasználó	User
működik	work
bele	into
igen	yes
von	von
persze	of course
róla	about
jön	come
lehetne	could be
akkor	then
élő	live
jelen	present
ill	and
végre	finally
különösen	in particular
bár	bar
magam	I
közé	between
képest	compared to
sajnos	unfortunately
felhasználók	Users
körül	around
megjelent	published
többet	more
fiatal	young
nemzeti	national
vezető	conductor
akinek	whose
neve	title
ismert	known
napon	day
also	bottom
szól	speak
tartozik	belongs to
jár	go
forint	forint
vagyis	that is,
történik	happen
érdekes	interesting
mail	mail
előző	previous
Ferenc	Ferenc
célja	The purpose
oda	ode
megint	again
elején	at the beginning
személyes	personal
továbbá	furthermore
tudjuk	We can
előre	forward
alkalommal	time
internet	Internet
végül	finally
szervezet	organization
játék	game
ezen	this
évvel	years
mivel	because
amíg	until
állami	state
ezzel	with this
komoly	serious
természetes	natural
semmit	nothing
fogja	will
hatalmas	powerful
folyamatosan	continuously
jelenlegi	current
legfontosabb	main
időben	on time
nekünk	us
ebben	in this
egy	one
egy	one
véleményed	your opinion
külföldi	foreign
pontosan	exactly
attól	from
látható	visible
van	there is
területén	field
tűnik	seems
sokan	many people
született	born
neked	thee
ehhez	to
részére	for
speciális	special
csapat	team
helyzet	state
keretében	framework
néha	sometimes
jogi	legal
tart	hold
maradt	remaining
vett	took
nekem	me
baj	trouble
rendelkezik	has
tette	his
tartott	held
hivatalos	official
marad	stay
elnöke	chairman
írta	written by
kevés	few
tehát	Therefore,
idén	this year
tartja	hold
napja	ago
egyáltalán	at all
minél	more
azonos	same
részben	partially
egyszerűen	simply
szeretnék	I would like to
den	den
mint	as
vagy	or
alkalmas	suitable
szerinti	according to
egyéni	individual
szent	saint
perc	minute
erről	about
alig	barely
amennyiben	inasmuch
azonnal	immediately
minden	all
jövő	future
legtöbb	most
szinten	also
ideje	Time
rendelkező	with
betű	letter
tudományos	scientific
nekik	them
amelyben	where
használt	used
országos	national
figyelembe	taking
gyors	fast
külső	outdoor
aki	who
eladó	seller
gyorsan	fast
pontos	accurate
továbbra	continue
erős	powerful
elé	before
lesznek	will
válik	become
években	years
mondani	say
láttam	I saw
Gábor	Gabor
iskola	school
annyi	so much
system	system
tartalmazza	contains
mindenkinek	Everyone
egyaránt	equally
legújabb	Latest
gondolom	I think
kedves	Dear
megyei	County
ingyenes	free
Sándor	Sandor
mar	bite
tartalmaz	It contains
további	further
tudják	they
állt	stood
főleg	especially
erre	this
vélemény	opinion
hagyományos	traditional
meg	to
tartozó	included
adni	give
jut	come
csoport	group
említett	mentioned
lehet	may
úton	en route
részét	part
könyv	book
kulturális	cultural
helyet	location
sajnos	unfortunately
annyit	much
ebből	from this
alábbi	below
ért	understand
kap	receive
fekete	black
mondjuk	say,
talán	maybe
probléma	problem
üzleti	business
nevű	more
mértékben	degree
napi	daily
név	name
tesz	do
egyet	one
személy	person
utána	after
ment	save
könnyen	easy
szervezetek	organizations
szívesen	willingly
valamilyen	any
oka	reason
kizárólag	exclusively
György	George
sincs	no
time	time
fórum	forum
munkát	work
egyébként	otherwise
írd	Write
nagy	great
egyedül	alone
választ	choose
engem	me
működő	active
jutott	remembered
tudni	to know
ugyanakkor	However,
francia	French
adja	enter
számú	No.
végzett	finished
section	section
Jézus	Jesus
mire	what
belőle	out
pénzügyi	financial
magyarországi	Hungary
tudtam	I could
társadalom	society
szeptember	September
sokszor	often
tíz	ten
mit	what
szociális	social
mások	others
információk	Information
rendkívül	Extremely
látszik	seem
központi	central
bizottság	committee
épp	right
természetesen	naturally
állandó	permanent
modern	modern
szerepet	role
írt	wrote
hely	place
összesen	all
embert	man
kötelező	compulsory
családi	family
egyben	at the same time
egymás	each other
lassan	slowly
egymást	each other
nemzeti	national
idején	at the time
annál	more
olyan	so
két	two
szóval	so
mondom	Telling
egyszerre	at the same time
valószínűleg	probably
minket	us
anyagi	material
tanár	teacher
ekkor	at
egyesült	united
szám	number
függ	It depends
Zoltán	Zoltan
anyag	substance
század	century
révén	through
király	king
tagjai	Members of
látogató	visitor
mutatja	shows
család	family
támogatás	aid
válasz	answer
programok	Programmes
formában	shape
bármilyen	any
miért	why
bennünket	us
azóta	ever since
múlva	After
eljárás	proceedings
fehér	white
helyezett	place
elektronikus	electronic
bármely	any of
elleni	anti
nevét	the name
közvetlenül	immediately
nagy	great
írja	writes
használni	to use
leginkább	mostly
tudta	He knew
kevesebb	less
érkezett	arrived
önálló	independent
szerepel	included
ház	house
várható	expected
felett	over
jellegű	character
ilyen	such
széles	wide
szépen	beautifully
képet	image
oktatási	Education
kereskedelmi	trade
feladata	task
országos	national
miközben	while
vendég	guest
előbb	before
sikeres	successful
vége	end
valamennyi	all
közvetlen	direct
víz	water
megoldás	solution
november	November
feladat	task
tetszik	like
lány	girl
múlt	past
mögött	behind
igénybe	available
azért	therefore
Imre	Imre
kevésbé	less
alapvető	essential
folyamatos	continuous
dolgot	things
tudod	You can
jelenik	will
nélküli	Wireless
elérhető	available
tér	space
látni	see
közt	between
oly	so
hozott	brought
egészségügyi	sanitary
rendszerek	Systems
tudnak	they
héten	week
ami	which
pozitív	positive
képek	Pictures
fenti	list
típusú	type
több	more
téma	topic
melyik	which
végig	through
azoknak	for
önkormányzat	local government
különleges	special
szót	word
amelyeket	which
magasabb	higher
mellé	next to
veszi	takes
nem	no
érte	for it
kéne	I should
műszaki	technical
magad	yourself
lap	sheet
ára	Price
szempontból	point of view
állam	state
többek	others
jellemző	features
mindkét	both
otthon	home
reggel	morning
szellemi	intellectual
tőle	his
hamarosan	shortly
vezetője	leader
olasz	Italian
biztosan	surely
könnyű	easy
iránt	towards
Tamás	Thomas
termék	product
hónap	month
készített	created
intézmény	institution
tudunk	We can
elmondta	He said
használható	usable
látom	I see
digitális	digital
indult	started
kapcsolódó	related
figyelmet	attention
így	so
kiváló	great
vette	It took
nálunk	book
többször	repeatedly
megjelenő	published
területen	area
alakult	founded
zenei	musical
miután	after
technikai	technical
Pál	Paul
biztonsági	Security
bizottság	committee
magukat	you
függetlenül	independently
szempontjából	terms
szereplő	included
eddigi	so far
kissé	slightly
mennyire	how
velük	them
gyerekek	children
létezik	exist
nyílt	open
termékek	Products
akarja	To
autó	car
állnak	available
tudott	could
verseny	competition
kapcsolatot	contact
helyes	correct
darab	play
ezer	thousand
budapesti	Budapest
történelmi	historical
követő	follower
szerződés	agreement
hozzászólások	Posts
abból	therefrom
intézmények	Institutions
amennyiben	inasmuch
tiszta	clear
nyelv	language
nyújt	offers
föl	up
cím	title
május	May
női	female
feltételek	conditions
hasonlóan	Like
adatokat	data
ezelőtt	ago
anyagok	Materials
egyetemi	university
civil	civil
eszközök	means
pénz	money
majdnem	almost
értem	I understand
sok	lot
egymással	each other
miniszter	minister
kezdve	From
majd	then
gyermek	child
szerzett	acquired
dolgok	things
rendszert	system
szeretném	I would like to
köszönhetően	owing to
rész	part
nők	women
terület	area
gép	machine
gyerek	child
rendelkezésre	available
látja	sees
meleg	hot
képesek	able
keres	look for
kész	ready
gyakorlati	practical
feladatok	Tasks
segítséget	help
ugye	right
következtében	due to
egyedi	unique
tartani	Keep
társaság	company
jóval	much
írni	write
rengeteg	a lot of
kérjük	please
semmilyen	no
rendelet	decree
Attila	Attila
körülmények	conditions
január	January
tegnap	yesterday
önkormányzati	local government
szintű	level
gond	worry
aktuális	current
que	que
pénzt	Money
érdekel	I am interested
ideig	time
hírek	news
idegen	foreign
érvényes	valid
időt	time
cikk	article
országban	country
rendszeresen	regularly
máris	already
vár	Castle
súlyos	serious
tavaly	last year
pedig	in turn
alacsony	low
szolgáltatás	service
járt	visited
ennyi	so much
adta	by
ehhez	to
szolgáltatások	Services
díj	fee
amint	as
zene	music
jelentette	said
iskolai	school
tervezett	planned
piaci	market
cégek	Companies
hírek	news
tudsz	You can
egyelőre	for the time being
magának	himself
december	December
milyen	what
hiba	failure
szólt	Commented
elnök	chairman
vesz	buy
legalábbis	at least
számít	calculate
szóval	so
címmel	title
polgári	civil
tevékenység	activity
állapotban	condition
akiknek	whose
nehezen	hard
forintot	HUF
idei	This year
hogyan	how
aminek	with
használata	Using
dolgokat	things
Miklós	Miklós
feltétlenül	absolutely
kapcsán	connection
konkrét	concrete
velem	with me
indul	start
beteg	patient
írtam	I wrote
gondoltam	I thought
utáni	after
legfeljebb	at most
kapcsolat	link
egységes	unified
tartalmazó	with
életét	life
mást	nothing
képviselő	representative
hisz	think
előzetes	preliminary
illeti	Concerning
járó	with
ettől	from
napig	days
augusztus	August
Krisztus	Christ
március	March
keresztény	Christian
eltérő	different
lép	spleen
menni	to go
mindössze	Only
nincsenek	no
sikerül	succeed
adminisztrátor	administrator
néhány	some
észre	notice
operációs	operating
évre	year
szerepe	The role
fizikai	physical
ráadásul	moreover
vajon	whether
épület	building
címet	address
szent	saint
lehetnek	may be
támogatást	assistance
haza	home
ennél	more
előtti	pre-
esik	fall
különös	strange
internetes	online
száz	hundred
esett	fell
amire	what
egy	one
június	June
teszik	make
hirtelen	suddenly
Béla	Béla
fiatalok	youth
készül	made
unió	union
információ	information
különféle	various
háború	war
programot	program
köteles	bound
körében	among
jövőben	future
részletes	detailed
némi	some
tartó	holder
cél	target
élete	life
hasznos	helpful
fognak	will
kötött	bound
együttes	combined
megvan	I have
nyelvű	speaking
helye	Location
mégsem	Cancel
rendelkeznek	with
évig	years
bizony	certainly
kapnak	Receive
szeretnénk	To
támogatja	Supports
származó	deriving
számított	calculated
viszont	however
embernek	man
információs	Information
lelki	spiritual
bal	left
levő	on
nos	well
szeretne	you want
érintett	affected
tanács	advice
szolgáló	serving
nevet	laugh
hatása	Effect
szöveg	text
ekkor	at
folyamat	process
katonai	military
képzés	training
oldalán	section
történet	story
internet	Internet
egykori	onetime
kérdések	Issues
kerülnek	are
megye	county
ipari	industrial
hosszabb	longer
névtelen	anonymous
olvasható	readable
akarok	I want
nyitott	open
köszönöm	Thanks
július	July
fogva	reason
utca	street
pályázati	tender
pályázat	competition
esetleges	accidental
segíteni	help
remélem	I hope
országok	Countries
csinálni	do
néven	As
óriási	giant
április	April
orosz	Russian
gazdag	rich
eredmény	result
kicsi	little
hozzászólás	Posts
továbbiakban	further
dolgozik	work
címe	Address
kérdést	question
Károly	Charles
havi	monthly
felelős	responsible
személyi	personal
szoftver	software
vettem	I bought
pozitív	positive
valódi	real
egy	one
két	two
értelmében	Under
mikor	when
aktív	active
igaz	true
először	first
tökéletes	perfect
kezdett	started
egyetem	university
zöld	green
érzem	feel
felelősséget	responsibility
oktatás	education
életet	life
mindegy	all the same
problémák	Issues
oldalt	sideways
nép	people
hang	voice
többen	more
kívánt	required
pontja	point
levelet	write
messze	far
kezd	begin
utoljára	the last time
szerző	author
tartalma	The content
filmet	Movie
úgy	so
ilyenkor	When such
kovács	blacksmith
foglalkozó	dealing
százalékos	percent
apró	small
megadott	given
barátom	my friend
eddig	so far
szabadon	free
fiú	boy
mondtam	I said
egyház	church
veszélyes	dangerous
honlap	Website
kedvenc	favorite
vezet	lead
világban	World
ugyanakkor	However,
viszonylag	relatively
kultúra	culture
regisztráció	Sign Up
bárki	anyone
úgynevezett	so-called
párt	party
eszembe	mind
nyelven	language
minisztérium	ministry
nyugati	west
évente	annually
mindenképpen	in any event,
használja	uses
fent	above
oldalra	page
embereket	people
mindenkit	everyone
úgyhogy	so
hozza	bring
maguk	themselves
értelemben	sense
különbség	difference
foglalkozik	deal
ajánlott	recommended
nyert	won
test	body
szabó	tailor
katolikus	Catholic
klasszikus	classic
uniós	Union
helyre	location
kíván	wish
sorozat	series
erősen	strongly
egészséges	healthy
alapítvány	foundation
pontot	point
számomra	me
komolyan	seriously
hátsó	rear
ott	there
les	les
százalékkal	percent
rendben	okay
éven	years
jelentősen	significantly
valójában	in fact
rögtön	immediately
valamelyik	one
immár	now
azután	after
információkat	information
tagok	Members
független	independent
délután	afternoon
biztosítja	provided
néz	look
közepén	in the middle
tartom	I
címen	at
várja	offers
alatti	below
híres	famous
cikkek	Articles
felső	upper
képeket	Pictures
kellemes	pleasant
innen	hence
biztosít	grant
beszél	speak
költségvetési	budgetary
városi	urban
látta	saw
informatikai	IT
öreg	old
biztosítani	provided
rosszul	poorly
végül	finally
zárt	closed
következik	follows
kemény	chimney
kivéve	except
meghatározó	determinative
hallottam	I heard
sötét	dark
hallgatók	students
közösen	together
általa	it
hős	hero
tartják	considered
színes	colorful
hálózati	power
kaptam	I got
üzenet	message
hiába	in vain
tény	fact
lakás	apartment
valahol	somewhere
élni	to live
megoldást	solutions
megyei	County
kettő	two
amúgy	anyway
ahogyan	as
tekintetében	As regards
remélem	I hope
heti	weekly
vállalat	company
közösség	community
akartam	I wanted
szüksége	need
órakor	o'clock
életben	life
sokáig	long
látott	saw
ahogy	as
amivel	which
friss	fresh
Mihály	Mihály
legyenek	are
ebből	from this
iránti	for
fele	half
gyakorlatilag	practically
felhasználása	Use of
lehetőségek	Activities
akarsz	do you want
mutat	show
szegény	poor
áron	price
valahogy	somehow
part	coast
lakosság	population
másrészt	on the other hand
lényeg	essence
föld	ground
problémát	issue
részéről	for
számítógépes	computer
ismeretlen	unknown
elérni	reach
per	grayling
negyedik	fourth
világon	world
magában	himself
példa	example
hallgató	student
folyamán	during
alkalmazott	employee
hozzászólást	Comment
eléggé	enough
helyzetben	situation
százaléka	percent
közösségi	communal
gyönyörű	beautiful
asszony	woman
mostani	present
pillanatban	moment
mielőtt	before
mindenféle	any
célra	purpose
oldalak	Websites
információt	information
témát	theme
nézve	looking at
nyugodtan	quietly
szeretem	love
időszakban	time
kerültek	They were
automatikusan	automatically
vizsgálat	investigation
épült	built
hivatal	office
adó	tax
fölött	Above
más	other
vasárnap	Sunday
orvosi	medical
kapta	received
válasz	answer
többnyire	mostly
téren	area
nincsen	There is no
piac	market
díjat	awards
ezután	thereafter
terén	area
folyó	river
máj	liver
világot	World
címre	address
jogosult	entitled
véve	account
melyben	where
egyházi	ecclesiastical
környezet	environment
kattintva	Clicking
csoportok	groups
fogják	will
hálózat	network
döntés	decision
szakemberek	Professionals
várhatóan	expected
lehetősége	Possibility
férfiak	men
beszélni	speak
körben	round
közönség	audience
egyértelműen	clear
fogok	I will
hamar	soon
rám	me
jót	good
munkáját	work
kétszer	twice
lépett	entered
napot	Day
nyári	summer
jogok	Rights
folyik	flow
szeretné	you want
fórum	forum
fenn	reservations
véletlenül	accidentally
szokásos	usual
ezután	thereafter
projekt	Project
utat	trip
régen	long ago
Tibor	Tibor
története	History
orvos	doctor
kezdődik	begin
kiderült	revealed
kifejezetten	expressly
zenekar	orchestra
érték	value
hatására	effect
gyermekek	children
velünk	us
alól	from
ezúttal	this time
ismeri	recognize
eszköz	device
számítógép	computer
magyarok	Hungarians
intel	intel
szavazás	vote
kialakult	developed
kapni	receive
leszek	I will be
partner	partner
formájában	form
gyenge	weak
adnak	they
legjobban	best
igény	claim
személyek	Persons
grafikus	graphic
végére	By the end of
ugyancsak	likewise
regionális	regional
miként	how
nőtt	grew
eredménye	results
tekintettel	view
játszik	play
útján	through
február	February
kérem	please
alkalmazni	apply
akart	He wanted
nyolc	eight
csodálatos	wonderful
mondott	said
sajátos	particular
csökkent	reduced
vezetői	managerial
méretű	Size
tetszett	I liked
lista	list
onnan	thence
dolgozni	to work
nyújtott	provided
hatékony	effective
életében	life
gyakorlat	practice
például	for example
halál	death
levél	letter
többsége	Most
tekintve	view
köztük	including
hideg	cold
mennyi	how much
kedvező	favorable
jelszó	password
joga	yoga
végső	final
üres	empty
lásd	see
forintos	HUF
városban	town
méltó	worthy
román	Romanian
választási	election
okoz	cause
másodperc	second
fejlesztési	developmental
olvastam	read
illetőleg	respectively
kiemelt	emphasized
megyek	I'm going to
nappal	day
örök	eternal
átlagos	average
hír	news
hány	how many
sms	sms
different	different
szervezett	organized
település	settlement
minőségű	quality
író	writer
vezetett	guided
talált	found
megjelenik	appear
kívánja	wishes
rendszeres	systematic
tanfolyam	course
kapsz	you get
miután	after
élt	lived
alsó	lower
naponta	daily
igazság	truth
erkölcsi	moral
kutya	dog
melyeket	which
dolgozott	worked
templom	temple
szeretet	love
normális	normal
önkormányzatok	municipalities
ingyen	Free
kezdte	started
hozta	brought
Mária	Mary
okt	October
mezőgazdasági	agricultural
döntött	decided
ugyanaz	same
eső	and he
meglévő	available
előtte	before
ugyanúgy	as well
igazgatója	director
kék	blue
negatív	negative
kommunikációs	Communications
egyesület	association
módszer	method
boldog	happy
kérdése	question
szabályok	regulations
közölte	said
vonatkozik	refers
meglehetősen	pretty
sőt	moreover
szerver	Server
nálam	I have
rendszerben	system
egymástól	apart
állandóan	constantly
voltunk	we've
magára	himself
nemzetközi	international
kiderül	reveals
piacon	market
amúgy	anyway
zsidó	Jewish
eset	case
tulajdonképpen	actually
élnek	living
százalék	percentage
nyelvi	linguistic
est	evening
szerződést	contracts
bejelentette	announced
foglalja	book
verzió	version
szolgáltatást	service
környezetvédelmi	Environment
engedélyével	permission
fővárosi	metropolitan
történelem	history
nyilván	record
mond	say
napos	sunny
megtalálható	found
szerelem	love
alkalmazása	Application
használják	used
modell	model
műszaki	technical
egyrészt	on the one hand
csaknem	almost
választott	elected
gazdaság	economy
valakinek	someone
vállal	undertake
kor	time
jövőre	next year
utcai	street
elegendő	sufficient
holnap	tomorrow
intézet	institute
szoba	room
nyilvános	public
határozza	determined
napján	day
működését	operation
római	Roman
szerzői	author's
anyagot	material
kezdődött	started
akiket	who are
sosem	never
Tóth	Toth
találtam	I found
ritkán	rarely
görög	Greek
szem	eye
amelyik	which
érzi	feel
mondják	said
értéke	value
tűnt	appeared
rendőrség	police
kapcsolatba	Contact
kínál	offer
bíróság	court
eredmények	Results
japán	Japan
napokban	days
amelyen	which
kisebbségi	Minorities
megbízható	reliable
függően	Depending on
alapvetően	basically
dolgozó	working
politika	politics
életpontot	hit points
kattints	click
ügyben	case
karakter	characters
könyvet	book
must	musts
irodalom	literature
fia	son
számát	The number
egyike	One
többé	more
szervezeti	organizational
akarnak	they want
fajta	species
foglalt	busy
mindennapi	everyday
lemez	plate
rendkívüli	extraordinary
hoz	to
ezáltal	thereby
amit	what
szolgáltató	Service
fejlesztése	Development
népszerű	popular
természet	nature
többiek	others
összeg	amount
abba	in that
alapú	based
irodalmi	literary
tanulók	students
működési	functional
rájuk	them
változás	change
lennie	be
kapcsolatok	contacts
változata	version
avagy	or
okozott	caused
jogot	right
sohasem	never
minőségi	qualitative
extra	extra
későbbi	later
keresek	Seeking
ennyire	so
találni	find
játszani	Play
volt	It was
feladatokat	tasks
rendezett	ordered
időre	time
gombra	Next
fizetni	to pay
előadás	live stream
itthon	home
személyesen	personally
legfőbb	chief
kedves	Dear
fogom	I will
véget	an end
számot	number
könyvtár	library
gondolja	think
falu	village
valamely	a
helyét	location
nevében	on behalf of
képviselői	Representatives
ebbe	in this
környezeti	environmental
környezetben	area
bármikor	whenever
brit	Briton
jelentése	Report
bekezdés	paragraph
drága	expensive
állítja	Sets
segít	help
kíváncsi	curious
kiadó	publisher
tartotta	held
magunkat	ourselves
legmagasabb	top
természeti	natural
szövetség	covenant
diákok	students
akarom	I
fontosabb	importantly
elektromos	electrical
mély	deep
azok	they
században	Century
amiben	which
nézni	watch
elől	Tires
vannak	are
elméleti	theoretical
közeli	close
segíti	assists
erről	about
bekezdése	Regulation
terv	plan
játékos	player
hatalom	power
témában	topic
talál	find
véleményét	Review
játszott	played
abszolút	absolute
furcsa	strange
ajánlom	I recommend
anélkül	without
illetően	as regards
tele	full
aránya	ratio
vizet	water
szolgál	serve
tervek	plans
beszélt	spoken
főként	mainly
illetékes	competent
veszik	taken
biztosított	insured
kutatási	Research
gépek	Equipment
telefon	phone
hiszen	because
tökéletesen	perfectly
hírek	news
kaptak	received
egyetem	university
kiegészítő	additional
valós	real
kínai	Chinese
árak	Prices
technológia	technology
lélek	soul
kiállítás	exhibition
három	three
felhasználói	User
címed	address
tavalyi	last year's
nyáron	in summer
körüli	about
hiányzik	miss
betegség	disease
értelme	Meaning
hit	faith
amiket	what
amellyel	which
játékok	Games
keleti	east
lehessen	be
éjszaka	night
elfogadott	accepted
méter	meter
egység	unit
bennem	me
tartanak	hold
just	just
kör	disease
piros	red
szombaton	on Saturday
jelzi	Indicates
kereskedelmi	trade
sikert	success
alap	basis
érkezik	come
kinek	everyone
fejét	head
Európában	Europe
azonban	but
tegnap	yesterday
nyomán	Following
végéig	the end
általában	usually
kapható	available
korai	early
értékű	featured
területi	regional
rendelkezésére	available
arra	to
finom	fine
téged	you
védett	protected
maximum	maximum
érintő	touch
számunkra	us
miniszterelnök	prime minister
ismeretek	skills
céljából	in order to
köszönöm	Thanks
világos	clear
lényeges	essential
tétel	item
kérdésre	question
jönnek	come
keresni	search
vevő	customer
ilyet	thing
központ	center
változások	changes
szempontok	Considerations
küldj	send
véleménye	reviews
eredményt	results
ráadásul	moreover
saját	own
tevékenységet	activities
török	Turkish
kiadott	issued
esetekben	cases
zenét	music
isteni	divine
közelében	close
üdv	welcome
szokott	usual
nem	no
úgyhogy	so
szemmel	eyes
olvasni	read
mellyel	which
ránk	us
lehetőségét	possibility
lettek	They were
add	add
hónapban	month
fontos	important
évet	Year
vizsgálata	Examination
akkori	then
szereti	Dislikes
polgármester	mayor
magába	Included
eredetileg	originally
események	Events
ügy	case
remek	great
értek	I
sorban	line
órát	watch
munkája	work
állat	animal
megállapodás	agreement
életre	life
kerülő	to be
várjuk	We await
játékot	games
közlekedési	Transport
mobil	mobile
adat	data
folytatott	with
nappali	living room
idők	Times
alakul	develops
valaha	ever
rendesen	neatly
különben	or else
kialakítása	design
lehető	possible
titkos	secret
figyelmét	attention
éreztem	I felt
körülbelül	about
jól	well
társaság	company
másfél	one and a half
ft/db	EUR / piece
figyelemmel	Subject to
biztosító	insurer
magával	along
hozni	bring
hajlandó	willing
változó	variable
fordult	turned
adatait	details
kivételével	Except
betegek	patients
korrekt	correct
elkészült	finished
kategóriában	category
távoli	remote
veled	with you
önmagában	itself
küldött	sent
emlékszem	remember
időszak	period
helyzetet	situation
lényege	The essence
hazánkban	Hungary
ellentétben	Contrary
töltött	stuffed
megfelel	meets
alacsonyabb	lower
nála	with him
fény	light
pályázatot	competition
véletlen	accidental
nyílik	open
rég	a long time ago
tudomány	science
millió	million
akarta	wanted
miszerint	that
mindig	always
állatok	Animals
kormányzati	governmental
kötet	volume
körű	comprehensive
adják	sold
témák	Themes
lennék	I'd
alapja	foundation
ezeket	these
Ltd.	Ltd.
hiánya	Lack
írásbeli	Written
kiss	kiss
csökken	decreases
tartoznak	included
javaslat	proposal
mindez	all
változott	changed
kettős	dual
tudás	knowledge
eleget	meet
korszerű	modern
mindenki	everyone
osztrák	Austrian
kiemelkedő	outstanding
szülők	parents
felnőtt	adult
fejlesztés	development
óráig	hours
fordul	turn
belüli	within
szerepelt	featured
gonosz	evil
utal	imply
fejlődés	development
együttműködés	cooperation
változik	change
tanulmány	study
felül	top
földön	ground
napra	day
adtak	sold
számtalan	countless
pénteken	Friday
szavakat	words
interneten	online
közelebb	closer
végzi	performs
lennének	would
szolgáltató	Service
földi	ground
szexuális	sexual
emiatt	therefore,
ifjúsági	juvenile
értékben	worth
tették	They were
források	Resources
kérni	ask
nyelvet	Language
Katalin	Katalin
vesznek	in
osztály	class
minimum	minimum
hibát	failure
esemény	event
mód	mode
plusz	plus
érzés	feeling
szánt	destined
stratégiai	strategic
hozzánk	to us
csatlakozás	join
érkező	arriving
számukra	them
rend	order
valakit	someone
feltétele	condition
határozat	resolution
dönt	decide
parlamenti	parliamentary
készülék	device
rendes	normal
döntő	finals
alapuló	on
magyarul	in Hungarian
ezeknek	these
látogatták	visits
épül	builds
várt	expected
emberiség	humanity
déli	south
változat	version
lát	see
ugyanolyan	same kind
oldalról	sides
tetején	on top
ősi	ancient
okozta	caused
felel	meet
fórumban	Forum
feladatot	task
kezdő	beginner
értékes	valuable
nehogy	lest
sehol	anywhere
olvassa	Read
cigány	Gypsy
hőst	hero
erő	power
szoros	tight
feletti	above
javaslatot	proposal
annak	to
szél	wind
országgyűlési	parliamentary
származik	originate
irányuló	to
vörös	red
korában	era
megjelenése	appearance
jelszót	password
értékek	Values
fut	run
módszerek	Methods
jelennek	appear
szét	apart
egyértelmű	clear
iskolák	schools
lányok	Girls
területek	Areas
írásban	in writing
véleményem	in my opinion,
sokan	many people
tekinthető	It is considered
igazgató	director
regisztrálva	registered
támogatása	Support
nemzet	nation
iskolában	school
olvas	read
vonatkozóan	on
tevékenységét	activities
vállalkozás	undertaking
vallási	religious
mindegyik	all
igényel	demand
profi	professional
mentén	along
vállalatok	Companies
megszokott	routine
vállalati	business
forrás	source
helyén	place
letölthető	download
helyszínen	the site
rendező	director
halála	death
energia	power
készíteni	create
ellátott	with
kutatás	research
nyerte	won
hatással	effect
módja	Method
Orbán	Orban
köszi	Thanks
Kossuth	Kossuth
honlap	Website
jogtulajdonos	Assignee
régóta	long since
nektek	you
dollár	dollar
művészeti	artistic
lényegesen	significantly
vettek	They were
közgyűlés	general meeting
hangsúly	emphasis
éri	reach
alaposan	thoroughly
sárga	yellow
honlapon	home
érdekes	interesting
föld	ground
előírt	prescribed
úgyis	anyway
amilyen	as
elért	achieved
résztvevők	participants
ritka	rare
órás	hours
tanuló	learner
vállalkozás	undertaking
kér	ask
kívüli	than
forma	shape
hír	news
szerep	role
országokban	countries
nevezett	said
mondták	They said
hibás	false
elemek	Items
tartalmának	contents
lehetőségeket	options
lehetetlen	impossible
századi	Century
esti	evening
képzési	Training
kezében	hands
tulajdonosa	owner
leírás	description
gyártó	manufacturer
célszerű	expedient
tudták	could
legszebb	the most beautiful
fórumon	forum
konferencia	conference
egyfajta	a kind
bíró	judge
jelentett	meant
szerepelnek	included
alapon	background
mára	today
szeretettel	love
várom	look forward
vették	taken
eredményeket	results
előnnyel	benefits
részén	section
szín	color
tettek	they
rád	Me
önkormányzat	local government
amint	as
felvételi	Shooting
közigazgatási	administrative
kérdéseket	issues
kérjük	please
izgalmas	exciting
üzenetek	Posts
támogatási	grant
hiányában	In the absence of
legutóbbi	last
szavak	words
pályán	pitch
kiválasztott	selected
mindez	all
arany	gold
eltároltuk	We have stored
kár	damage
maximális	maximum
mostanában	recently
öröm	pleasure
eredményeként	As a result of
könnyebb	lighter
húsz	twenty
írásos	Written
akció	action
végleges	definitive
tényleges	actual
cím	title
királyi	royal
köszönjük	Thank you
küldeni	sent
használ	use
kattint	click
siker	success
felsőoktatási	Higher Education
szint	level
ötlet	idea
nagyszerű	magnificent
áfa	the tree
bemutató	premiere
emelkedett	increased
látjuk	We see
szocialista	socialist
azért	therefore
használatát	use
megelőző	prophylactic
jöttek	come
feleség	wife
legkisebb	least
valóságos	real
éppen	just
Hungária	Hungaria
módosító	amending
vezette	headed
olcsó	cheap
vizsga	examination
várják	expected
önnek	for you
rendezvény	event
határozott	definite
hülye	stupid
állapot	status
területeken	areas
költségek	expenditures
semmiféle	no
környékén	area
határon	border
sima	smooth
kiadó	publisher
állítólag	supposedly
első	first
eljárást	procedures
kommunikáció	Communication
siker	success
távol	away
hol	where
követi	follow
ábra	figure
belépés	entry
technológiai	Technology
kutató	researcher
tesznek	they
szigorú	strict
induló	march
választás	choice
köztársaság	republic
működik	work
folyamat	process
oldal	page
fogunk	we'll
néző	viewer
lépni	move
kénytelen	forced
közben	during
költségvetés	budget
piacra	market
média	media
mindezt	all
kérem	please
hétfőn	Monday
valóság	reality
számon	No.
köze	close
legfrissebb	Latest
mennyiségű	volume
világháború	World War II
pálya	court
átfogó	comprehensive
honnan	from
létező	existing
hozzájuk	to them
üzenetet	a message
tudom	I know
adatai	Details
megoldani	solve
szeret	love
próbálja	try
kezdeni	start with
nemi	some
engedély	license
elég	enough
nép	people
válogatott	selected
dolgoznak	working
havonta	per month
beépített	built-in
biztonságos	safe
spanyol	Spanish
összeget	sum
tanulni	learn
kérte	asked
képviselője	The representative
akkora	size
hittem	thought
teljesítmény	performance
építési	building
gondolok	I think
standard	standard
időn	time
kora	early
valami	something
színű	colors
informatikai	IT
hallgatói	students
fokozatosan	gradually
indított	launched
ilyenkor	When such
hozzám	to me
történeti	historical
sikeresen	successfully
tárgy	subject
hangja	voice
pályázatok	Applications
tudtak	could
pusztán	merely
és	and
akarják	they want
beleértve	including
gazdája	owner
épülő	based
vélemények	Reviews
egyszer	once
megyében	County
gáz	gas
sport	sports
kérdezte	he asked
pedagógiai	pedagogical
fejlett	developed
fős	people
vidéki	rural
hátha	haha
ugyanazt	the same
téli	winter
főváros	capital
programban	program
épített	built
szabott	customized
támogatásával	supported by
jelentkezik	occurs
rádió	radio
virtuális	Virtual
bonyolult	complex
sajtó	press
versenyt	competition
fogadta	accepted
szerdán	Wednesday
tartós	durable
érhető	available
nemrég	recently
album	album
technika	technique
északi	north
szabályozás	regulation
lassú	slow
adatbázis	data base
mennek	go
találhatók	found
senkit	anyone
csomag	package
jogokat	rights
biztosítása	Ensuring
szolgálja	serving
testi	physical
egyesület	association
kedden	Tuesday
minimális	minimum
testület	body
egyenesen	straight
jelölt	candidate
lengyel	Polish
gyorsabb	Faster
pápa	pope
eredetű	surname
összege	The amount
mutatják	show
mutatott	shown
joggal	right
elem	element
szöveget	text
készítette	created
eleve	a priori
írás	writing
kellő	due
kezelés	treatment
szakma	profession
roma	Romany
gyakorlatban	in practice
komplex	complex
levélben	letter
felől	From
egyedülálló	single
kialakított	with
válaszolt	reply
csoda	wonder
szóba	room
ajánljuk	We recommend
következett	occurred
filmek	Movies
alapul	Based on
kerületi	circumferential
gondot	trouble
ideális	ideal
forgalom	traffic
tekintetben	respect,
lettem	I
később	later
tanulmányi	study
forradalom	revolution
számban	numbers
jelenség	phenomenon
szoktam	I used to
dolgozók	staff
felében	half
vagyis	that is,
folyamatban	in progress
összefüggő	connected
csinál	do
tapasztalatok	Experience
órán	hours
mérték	measurement
ahhoz	thereto
vizsgálat	investigation
létrehozott	created
tisztában	clear
telefon	phone
múlik	pass
héttel	weeks
meghalt	died
mellette	next to
amiért	for
személyre	personalized
manapság	these days
kézzel	by hand
fontosnak	important
hatását	effect
kártya	card
gondolat	thought
címét	address
vallás	religion
szobás	Bedroom
válaszolni	answer
elsődleges	primary
SZDSZ	SZDSZ
irányba	direction
nézett	looking
fővárosi	metropolitan
process	process
szabadság	freedom
hívják	called
szokás	custom
szerencsére	fortunately
elsőként	first
párhuzamosan	parallel
kilenc	nine
stb	etc.
külföldön	abroad
ablak	window
országgyűlés	parliament
minek	what for
szar	shit
részében	section
növekvő	growing
szűk	narrow
fogjuk	We will
hívja	calling
helyére	place
lapot	sheet
államok	States
értéket	value
formája	shape
lépés	step
provides	provides
megváltozott	changed
legyen	whether
Németh	Nemeth
éjjel	night
hangot	voice
levegő	air
előadást	performance
végtelen	endless
szövetség	covenant
tájékoztatást	information
ennyit	so much
mindenütt	everywhere
nagyjából	roughly
kitűnő	excellent
mégpedig	namely
szeme	eyes
egymáshoz	together
művészet	art
közgyűlés	general meeting
szervek	agencies
library	library
tartották	held
színház	theater
tevékenysége	activities
ugyanis	namely
vajon	whether
telt	full
olyanok	others
féle	kind of
egyenlő	equal
igyekszik	tries
múzeum	museum
keletkezett	generated
ben	in
gyorsabban	faster
jelentkező	candidates
egymásra	each other
bármelyik	either
hajó	ship
részletesen	in detail
jogszabály	laws
Árpád	Árpád
access	access
embereknek	People
fiúk	Boys
jelentősége	Importance
hátrányos	disadvantaged
several	Several
örülök	I am glad
szerezni	gain
ismerem	I know
költő	poet
hivatalosan	officially
utcán	street
fölé	above
globális	global
stabil	stabile
bizonyult	proved
mértékű	degree
mindjárt	anon
lényegében	essentially
bank	bank
hónapos	month
tettem	I have
interface	interface
srác	tad
akarjuk	To
kapunk	we get
egyéb	other
alkotó	creative
választani	choose
amiről	what
meghatározása	Determination
régió	region
kiadás	expenditure
indokolt	justifiable
mindenesetre	in any event
mire	what
bei	bei
kód	code
nyilvánosságra	published
illető	respective
hogyha	that if
foglalkozni	deal
percig	minutes
művész	artist
berendezések	facilities
web	web
hallani	hear
gondolod	think
fogadja	accept
jol	well
szomszédos	neighbor
szomorú	sad
segítő	helper
programokat	programs
addig	before
ifjú	youngster
emellett	besides
kérdésekre	questions
rejtett	hidden
kedvéért	for the sake of
állítani	set
míg	while
távon	run
akarunk	We want to
hétvégén	weekend
antal	Antal
helyzete	The situation
könyvek	Books
back	back
beállítása	Setting up
régebbi	older
hátra	back
olvasó	reading
integrált	integrated
szembe	eyes
távú	-term
para	cork
központ	center
ötödik	fifth
vicc	joke
gazdasági	economic
gépet	machine
válnak	become
első	first
írd	Write
változtatni	to change
különösen	in particular
közti	between
sie	sie
fórumot	forum
általános	general
csütörtökön	Thursday
small	small
jók	good
azóta	ever since
túli	beyond
mekkora	what
hagyja	leave
könnyedén	with ease
semmi	nothing
wap	wap
mozgalom	movement
example	example
nach	nach
mail	mail
koncert	concert
kezelni	handle
abban	therein
fejezet	chapter
találtak	found
igencsak	pretty
meglepő	surprising
száraz	dry
tartalmi	content
kijelölt	assigned
magától	self
wir	wir
latin	Latin
egyidejűleg	simultaneously
torta	cake
kis	little
hangzik	sound
change	change
kezdtem	I started
írok	I am writing
döntést	decision
várnak	expect
ahonnan	from where
példát	examples
tulajdonos	owner
intézményi	institutional
inkább	rather
senkinek	anyone
kosár	basket
bármi	whatever
kifejezés	phrase
kezét	hands
javasolt	recommended
összesen	all
máshol	elsewhere
port	port
életének	life
igényes	demanding
nyitva	open
csapatok	troops
forró	hot
biológiai	biological
hivatal	office
böngészi	online
varga	cobbler
kapcsolódik	connected
dokumentumok	Documents
tárgyak	items
kint	outdoors
számában	issue
bruttó	gross
utcában	on the street
endre	endre
ugrás	jump
alkalmával	occasion
hatást	effect
magazin	magazine
küldd	Send
szakember	expert
kicsit	a bit
részletek	details
részvétel	participation
fekszik	lying
járnak	act
felhasználókat	users
színházi	theatrical
világszerte	worldwide
klub	club
terjed	spread
összhangban	In accordance with
vendégek	Guests
alakú	shape
százalékát	percent
given	given
tanárok	teachers
olykor	Sometimes
akivel	I've
ifjúsági	juvenile
olyat	anything
csendes	quiet
területet	area
erőt	power
hetente	weekly
megjelent	published
szovjet	Soviet
püspök	bishop
törvényben	Law
demokratikus	democratic
tőlük	them
amelyre	which
jel	sign
átmeneti	transition
villamos	electrical
fordított	reverse
illik	match
tárca	wallet
jegy	ticket
hagyta	leaving
molnár	miller
műsor	show
high	high
felesleges	unnecessary
kiadása	release
hamarabb	sooner
rendszere	System
rosszabb	worse
gyakori	frequent
ingatlan	property
jogát	right
találta	found
nap	day
ellenőrzés	check
halálos	deadly
politikus	politician
ismerik	known
perces	minute
fekvő	lying
gondolkodás	thinking
közzé	published
adták	sold
java	java
igazából	actually
reggeli	morning
megoldások	Solutions
noha	although
forduló	turn
állást	job
autót	car
általuk	they
készítése	Create
nyugodt	calm
erdélyi	Transylvania
túlságosan	too
bek	§
állami	state
tilos	prohibited
eladó	seller
feb	feb
egészében	whole
tartalmaznak	contains
Szeged	Szeged
unalmas	boring
egyik	one
számok	Numbers
magunk	ourselves
egyház	church
vesszük	We
növekedés	growth
hova	where
emellett	besides
felsorolt	listed
egyúttal	at the same time
bácsi	Uncle
utazás	travel
tudományos	scientific
látják	see
isten	God
színész	actor
határidő	deadline
bűn	sin
valamivel	slightly
célú	Purpose
érthető	understandable
normál	normal
akarod	you want
lehetőleg	if possible
művészi	artistic
csapata	The team
tőlem	me
jelentkezett	signed
megvalósítása	implementation
egészet	all
szeretnél	you would
érezte	feeling
elismert	acknowledged
törvények	laws
mért	measured
durva	rough
kaptál	you got
megrendezésre	place
névre	the name
szerettem	I
mélyen	deep
apja	his father
folyt	cont
találunk	found
keresett	sought
anyagokat	materials
szélesebb	wider
klub	club
szemét	garbage
csökkenti	decreases
tel	tel
tegnapi	yesterday
bekezdésében	Regulation
cseh	Czech
csakis	only
tanult	learned
special	Special
kapja	receive
ülésén	session
színház	theater
jártam	I
tanács	advice
kis	little
házban	house
órától	am
szerencsére	fortunately
szerv	organ
szert	gain
kéri	asks
futó	runner
istennek	god
rajtuk	them
idősebb	elder
hete	Hey you
találták	found
tartalmát	contents
délelőtt	before noon
bizonyára	surely
mögé	behind
írj	Contact
ahová	where
számának	number
képviselők	MPs
kelt	cause
azokkal	with
hazánk	Hungary
hamis	false
vér	blood
tegye	do
érinti	affect
műanyag	plastic
vezeti	leads
terméket	product
kezelése	Treatment
können	können
fejlesztők	Developers
amíg	until
pályázó	applicant
elvileg	in principle
növények	plants
munkák	Jobs
közepes	medium
szolgáltatásokat	services
problémád	problems
kérek	me
korban	Ages
gyári	manufacturing
nemes	noble
feltételeket	conditions
vállalkozó	entrepreneur
sokféle	a wide variety of
oldalakon	sites
minisztérium	ministry
bennük	they
mind	all
teszt	test
bemutatott	featured
azonnali	instant
témához	topic
alkalmazható	applicable
okok	reasons
bekezdésben	paragraphs
alapos	thorough
őszi	autumn
eszközöket	tools
tök	pumpkin
hatóság	authority
igaza	right
munkatársai	staff
típus	type
Medgyessy	Medgyessy
várni	wait
véleményt	review
pap	priest
támogatott	supported
hölgy	lady
pártok	parties
bármit	whatever
beszélgetés	conversation
mentem	I went to
felújított	reconditioned
jellemzi	characterized by
helyesen	correctly
mester	master
tűz	fire
szoftvert	Software
Jézus	Jesus
látványos	spectacular
elengedhetetlen	indispensable
baráti	friendly
találja	finds
újat	new one
Judit	Judit
időnként	sometimes
végző	performing
választások	elections
arányban	ratio
beruházás	investment
vagyon	property
mindenhol	everywhere
szempont	viewpoint
minőség	quality
versenyen	Competition
összefüggésben	context
cikket	article
otthoni	home
bemutatása	Presentation
létrehozása	Create
tavaszi	spring
anya	maternal
pontosabban	accurately
por	powder
programs	programs
beszélve	mention
érdemes	worth
másodközlése	republished
közülük	them
ettől	from
újból	again
national	National
teve	camel
legtöbbször	most
célok	Goals
éjszakai	night
linkre	link
főbb	The main
közelmúltban	Recently,
kht.	kht.
készülő	upcoming
vállalt	undertaken
diák	student
kerülhet	reach
kerülni	Avoid
nyár	summer
jogszabályok	laws
legközelebb	next time
készültek	made
funkció	function
ereje	power
amin	amines
országot	country
röviden	short
Széchenyi	Széchenyi
általunk	Our
bátran	bravely
research	research
come	come
mérkőzés	match
családok	family
újság	newspaper
beszéd	speech
ellene	against
számos	several
ellátás	supply
hangsúlyozta	He stressed
mutatta	revealed
einem	einem
másikat	other
erővel	forcibly
csomó	bunch
szerves	organic
hihetetlen	incredible
résztvevő	participant
táblázat	table
stratégia	strategy
alkalmazások	Applications
önkéntes	voluntary
kocsi	car
mindkét	both
kizárólagos	exclusive
percben	in minutes
forgalomba	circulation
keveset	little
hetes	week
alapító	founder
olcsóbb	cheaper
térkép	map
hatósági	official
káros	harmful
ilyesmi	anything
mer	mer
erősebb	stronger
rögzített	fixed
ezenkívül	Besides that
jegyében	spirit
web	web
varázslatot	spell
utána	after
gondolta	thought
SMS	SMS
éles	sharp
vers	verse
valamikor	sometime
dal	song
melletti	next
támogató	supporting
édes	sweet
későbbiekben	subsequently
dolga	do
másképp	otherwise
hatás	effect
nyújtani	submitted
átlagosan	on average,
módosított	modified
megadni	given
képen	image
tényleg	really
vékony	thin
honlapján	website
teljesen	completely
anyanyelvű	mother tongue
eszközökkel	tools
harc	fight
okból	from
alkalmából	on the occasion of
eredményes	successful
köszi	Thanks
mégis	yet
szlovák	Slovak
jöhet	come
állította	claimed
végezni	perform
tartalom	content
szerzők	authors
használatával	Using
találkozó	appointment
ajtó	door
betegségek	Diseases
illő	volatile
álltak	They were
keresi	looking
hal	fish
hozzászólására	post of
lefelé	down
szex	sex
fantasztikus	fantastic
mondható	cancellable
nyomtatott	printed
tartjuk	We
csatorna	channel
történetét	history
szak	vocational
uralkodó	ruling
tényező	factor
nyilatkozta	said
teli	full
leggyakoribb	top
élmény	experience
megnézni	watch
megtörtént	has been
irányban	location
teret	space
arany	gold
irányár	target price
oktatási	Education
támadással	attack
debreceni	Debrecen
mutató	indicator
egymásnak	each other
leírt	described
működése	operations
újonnan	newly
mindenesetre	in any event
adhat	You can
biztos	commissioner
létrehozni	Create
felek	parties
kar	arm
egyenes	straight
szólva	Speaking
község	township
szinte	almost
social	social
zajlik	take place
hősöd	hero
szorosan	close
könyvtár	library
mondjuk	say,
másként	otherwise
felhasználható	usable
tapasztalat	experience
foglaltak	reservation
védelmi	defensive
nehezebb	heavier
ünnepi	gala
tehet	talent
igazad	right
professzor	Professor
elfogadta	accepted
szigorúan	severely
bizonyítja	proves
honlapja	Website
köszönhető	due
jutnak	reach
részének	section
népi	folk
egyre	ever
jobbra	right
szakértők	experts
vezetésével	leadership
feje	section
szakértői	Expert
fogalma	The concept
szeretett	beloved
könyve	book
eredményei	Results
nevelés	education
találsz	find
mailben	Email
okos	clever
DVD	DVD
tartunk	We are
képezi	is
zene	music
irányába	towards
harminc	thirty
angolul	English
leveleket	leaves
iroda	office
vezetők	Leaders
magyarság	Hungarians
fogsz	are you going
van	there is
konyha	kitchen
ülés	seat
tisztelt	respected
kutatások	Research
könyv	book
melyen	where
választotta	selected
tisztán	clear
gyakorlat	practice
folytatni	continue
rövidebb	shorter
értünk	us
vehető	available
fizetési	payments
terem	hall
használnak	used
önmagát	oneself
érzelmi	emotional
magához	himself
portál	portal
dollárt	dollars
jellegzetes	characteristic
előtt	before
központi	central
bőr	skin
viszonyok	relations
hagyott	leaving
tartottak	held
demokrácia	democracy
keresés	search
esetek	Cases
akad	there
tekinti	consider
váltak	become
állapota	status
nettó	net
játékok	Games
halad	proceed
állni	Availability
azokra	apply
ezekkel	these
követte	followed by
problémákat	issues
szerkesztőség	editorial
kritikus	critical
középkori	medieval
jutottak	reached
felszerelt	equipped
gépen	machine
hiteles	authentic
értékét	value
valószínű	likely
linkek	Links
egyes	single
kötelezettség	commitment
öröm	pleasure
jutni	reach
orvosok	Doctors
működnek	work
igények	needs
befolyásolja	affect
hónapja	Month
rendőr	police officer
leszel	you'll
értelmes	intelligent
gondolom	I think
szolgálat	service
maradtak	stayed
vállalja	agree
helyzetbe	position
valamiféle	some kind
barna	brown
vállalunk	We are
jelek	Signs
támogatások	grants
rendszerint	usually
hagyni	leave
védelme	Protection
előadások	performances
kezdeti	initial
sebezve	sebezve
külön	separately
bír	have
ötven	fifty
helyzetét	situation
biztosítási	Insurance
csak	only
akadémia	academy
valóban	really
könnyebben	easier
növeli	increases
szabályokat	rules
követ	follow
szerinte	according to him
soron	line
Petőfi	Petofi
felhasználóknak	Users
távközlési	Telecommunications
néztem	I looked
aláírás	signature
érdekelt	interested
korlátozott	limited
Jenő	Jeno
férje	husband
Anna	Anna
földrajzi	geographical
felmérés	survey
testét	body
vezetése	leadership
létrejött	created
forgalmi	Traffic
felmerült	arisen
nevezte	called
csengőhang	ringtones
felsőfokú	superlative
pillanat	moment
készülnek	made
néha	sometimes
témája	Topic
kulturális	cultural
vastag	thick
parancsot	command
kényelmes	comfortable
PHP	PHP
BBCode	BBCode
érdeklődés	interest
név	name
bizonnyal	certainly
elhelyezett	placed
elfogadja	accepts
elsősorban	primarily
mondat	sentence
ügyében	case
feltételeit	terms and conditions
simán	smooth
hasonlít	similar
tömeg	mass
szeretnének	looking
csoportba	groups
gomb	orb
idős	elderly
ketten	two of them
járni	walk
napok	Days
tekinteni	considered
összetett	complex
különbséget	difference
üzeneteket	messages
szegedi	Szeged
ugyanazon	the same
interneten	online
önállóan	own
hangulat	mood
béke	peace
kategória	category
árt	hurt
jelentés	report
pályára	careers
ide	here
pontok	Points
feltételei	Conditions
mesterséges	artificial
készen	ready
álláspontját	views
esélye	chance
fogyasztói	consumer
kijelentette	said
adatot	data
jelentő	reporting
results	results
dolláros	dollar
elküldjük	sent
zavar	confusion
alkotott	created
mintha	as if
vegye	Remove
vegyes	mixed
földre	down
tagjainak	members
iroda	office
eltelt	passed
üzlet	business
legendás	legendary
adunk	added
késő	late
egyén	individual
vinni	bring
főiskolai	college
maradnak	stay
szabvány	standard
vezetés	driving
kér	ask
szerencsés	fortunate
bor	wine
versenyző	competitor
átlag	average
szombat	Saturday
használjuk	Use
leszünk	We will be
fogod	You will
szintjén	level
szeretnek	love
tanulás	learning
politikusok	politicians
tükrözik	reflect
szenvedett	suffered
statisztikai	statistical
kerület	district
közölt	published
keresünk	We are looking for
gyere	come on
birtokában	possession
halott	dead
köt	bind
szürke	gray
elindult	started
iskola	school
megyünk	We're going
igenis	indeed
Ágnes	Agnes
módosítása	Change
ellenében	against
okozhat	cause
mit	what
ezekben	these
tárgyi	material
ült	sat
támogatására	support
eljárások	procedures
látták	Seen
parlament	parliament
nézzük	let's
megtalálja	find
kísérleti	experimental
helyeken	places
kereső	finder
tudod	You can
másnap	the next day
neves	noted
kérdésben	issue
hírlevelünkre	our newsletter
szépségápolás	cosmetology
tenger	sea
újabb	another
bőven	plenty
bejelentkezve	logged in
mentek	gone
lépéseket	steps
túl	too
keretek	frames
dinamikus	dynamic
haladó	progressive
közszolgálati	Public Service
kémiai	chemical
hatályba	force
kellemetlen	unpleasant
uram	mister
mozgás	move
Debrecen	Debrecen
hadd	let me
memória	Memory
megmaradt	remaining
hirdetés	ad
tuti	definitely
szept.	September
leendő	prospective
mindenkinek	Everyone
törvényt	Law
szakasz	platoon
történhet	happen
készít	prepare
kívánok	I wish
javára	benefit
igényt	claim
híreket	news
tudna	could
utazási	travel
ellentétes	opposite
esetleg	maybe
foglalkozott	dealt with
lelkes	enthusiastic
területe	area
térség	Area
kölcsönös	mutual
szoftverek	Software
többféle	Several
javítása	Improving
vizsgált	examined
megjegyzés	comment
erők	Forces
továbbá	furthermore
mennyit	how much
kaptunk	We
képtelen	unable
vetett	cast
alapított	founded
elég	enough
akik	who
lévén	Being
kezdi	begins
szerep	role
berendezés	equipment
játékosok	Players
kormányzat	Government
processzor	processor
szép	beautiful
mindenre	everything
télen	in winter
arány	gold
fejlődése	development
érzékeny	sensitive
idővel	time
halt	died
Simon	Simon
folytatja	continues
bent	inside
számítástechnikai	computing
fed	cover
bajnoki	championship
engem	me
neked	thee
állunk	We are
verziója	version
elküldöm	Send to
kérdésed	questions
következménye	consequences
meghaladja	greater than
engedélyt	permit
programja	program
igénylő	requiring
bécsi	Viennese
nyilvánvaló	obvious
végett	In order to
idén	this year
picit	little
elterjedt	current
után	after
alábbiakban	below
államokban	States
látod	see
látszott	It seemed
épületek	buildings
Matáv	Matáv
vidám	hilarious
őszinte	honest
gyártók	Manufacturers
baleset	accident
szerelmes	in love
farkas	wolf
kivétel	exception
Bálint	Valentine
várunk	welcome
bajnok	champion
végre	finally
katona	soldier
bemutatni	presented
tárgyalások	Negotiations
választották	elected
listája	List
részvételi	participation
frissen	fresh
GSM	GSM
tényezők	factors
sorra	lines
felület	surface
írott	written
következők	follows
alkalmazás	application
visszatért	return
tudomásul	Takes
faj	race
téve	camel
elhangzott	said
termékeket	products
házi	home
automatikus	automatic
elérte	reached
komolyabb	serious
áruház	department store
tudtuk	We could
növekedése	growth
felét	half
nagyot	big
minél	more
mégiscsak	after all
rövid	short
célt	target
gyakran	often
tevékenységek	Activities
eredményeit	The results
végezte	completed
élünk	about
tanári	teacher
mindenkori	current
vallásos	religious
BSD	BSD
olvasás	reading
szóban	orally
felhasználásával	Using
Ádám	Adam
igénye	demand
előnye	benefits
bizonytalan	uncertain
ezekre	these
játszanak	play
írd	Write
települések	settlements
október	October
változást	change
Norbi	Norbert
pontban	section
Róbert	Robert
alján	at the bottom
mérete	Size
megjelölt	marked
gondolatok	Thoughts
szolgáltatások	Services
leírása	Description
érdekeit	interests
védelem	protection
szövegek	texts
derül	revealed
árát	reap
alkalom	time
közöttük	included
szintre	level
oldali	right
kommunista	Communist
évesen	At the age of
szobában	room
egykor	When a
hibák	errors
sajna	unfortunately
privát	Private
ügyvezető	manager
egyszerűbb	easier
hamarosan	shortly
elképzelhető	imaginable
Mátyás	Matthias
ily	this
szeretnéd	you want
rendszerváltás	regime change
növekszik	grow
eltűnt	disappeared
bocs	sorry
bevezetése	The introduction
enyém	mine
modellek	models
eleme	items
jelszavad	password
bíróság	court
intézkedések	actions
támadás	attack
kevesen	few
számító	calculating
tapasztalt	experienced
biztonság	security
fordítva	inversely
sorsa	The fate
építeni	build
témákat	topics
programmal	program
helyébe	replaced
hatású	effect
útra	from
elment	gone
postai	postal
vízzel	water
holott	although
várost	city
foglalkoznak	deal
neten	The Net
elkövetett	committed
miről	what
kapitány	captain
szavazást	poll
hatályos	force
szótár	dictionary
hálózatok	Networks
maradjon	stay
ilyenek	such
csatlakozási	connection
tartva	Bearing
beszélnek	speak
tölti	fill
találkozik	come across
szeretik	love
stílus	style
buli	party
nyomon	follow
szellem	spirit
képe	Picture
hagyjuk	leave
folytatta	he continued
gondoskodik	take care
fiatalabb	junior
belföldi	domestic
fejlesztési	developmental
sérült	injured
fiam	my son
fák	trees
látogatta	visited
teszem	I
balra	to the left
vonal	line
játszó	playground
felfelé	up
munkával	work
fájl	file
lakossági	Retail
maga	itself
véli	view
érdeklődők	Interested
felhasználni	used
megtekintéséhez	view
formátumban	format
nevezik	called
előre	forward
működésének	operations
híd	bridge
partján	coast
életem	life
közepette	Amidst
céllal	Relationship
végez	perform
közeljövőben	near future
alkotmányos	constitutional
ismét	again
válaszul	reply
hozták	brought
alapítvány	foundation
nemcsak	not only
hozzászólásra	add comment
MÁV	MÁV
jelezte	indicated
ingyenesen	free
figyelem	attention
hiába	in vain
szereplők	players
lapok	Sheets
kidolgozott	developed
kezdtek	started
gondolni	think about
követni	follow
nyilvánvalóan	obviously
tárgya	Object
alternatív	alternative
megjelenés	appearance
ugyancsak	likewise
maradni	stay
pesti	Pest
bírósági	judicial
rajtam	me
anyanyelvi	native
próbáltam	I tried
barátja	boyfriend
menj	go
mozog	move
fejlődő	developing
keze	hands
szöveges	text
forinttal	HUF
szembeni	to
hónappal	months
megállapított	down
benyújtott	submitted
írtak	written
meccs	match
terjedő	spreading
utólag	later
MDF	MDF
földet	land
intenzív	intense
levelek	Leaves
puszta	bare
elfogadható	acceptable
folytatódik	continue
kerüljön	be
szálloda	hotel
méteres	m
szövetsége	alliance
optikai	optical
érdeklődő	interested
letöltődik	downloaded
kezelésére	treatment
úti	travel
direkt	Direct
harci	fighting
elfogadni	adopted
szükségessé	necessary
Németországban	In Germany
ismereteket	skills
ősszel	in autumn
szilárd	solid
hoztak	have
egyebek	others
romantikus	romantic
mindezek	thereof
kevesebbet	less than
tisza	Yew
viszi	takes
parancs	command
szólnak	speak
állít	claim
felvétel	recording
hatóságok	Authorities
vasúti	railway
megszűnik	cease
társkereső	dating
csúnya	ugly
szerkezet	structure
arról	about
amihez	which
holland	Dutch
hőmérséklet	temperature
megvalósítani	achieve
kérlek	please
köré	around
tájékoztató	informative
energiát	power
alkalmazásával	using
svéd	Swedish
kezeli	treats
töltötte	spent
műve	operations
dupla	double
csapatot	team
időpontja	Date
magazin	magazine
félév	half-year
követelmények	requirements
mobilodra	Cell Phone
városok	towns
karaván	caravan
reklám	advertising
kapcsolódó	related
péntek	Friday
iraki	Iraqi
közlekedés	transport
jelentenek	mean
nyújtó	offering
akárcsak	even
művek	works
ülésen	session
lépést	steps
zajlott	It took place
ajánlani	offered
találkoztam	I met
fáj	species
korán	early
ideiglenes	temporary
utak	roads
állomány	staff
anyja	mother
tervezés	design
tanulmányok	studies
legjelentősebb	most important
helyette	instead
tűnő	looking
egyszerűen	simply
szólni	speak
időm	time
szavazni	to vote
nevek	names
eszébe	remember
jónak	good
határozottan	firmly
termelés	production
lehetőségeit	the possibilities
segítség	help
kezébe	hands
kezdetben	initially
Amerikában	America
vonatkozásában	respect
félig	half
enni	to eat
böngésző	Browser
minősül	is considered
számítógépek	Computers
hadsereg	army
felelősség	responsibility
feladó	sender
csekély	slight
ismerte	described
címszó	keyword
folytán	Due to
tőlünk	us
teljesítményt	performance
kortárs	contemporary
tartalmazzák	included
részletek	details
használat	use
hangzott	It sounded
fizetett	paid
katonák	soldiers
sebesség	speed
tagállamok	Member States
államtitkár	under-secretary
azon	is your
kiadvány	publication
fáradt	weary
beállítások	Settings
varázspont	Magic point
állítják	claim
nyilatkozott	said
éppúgy	as well
HUF	HUF
rendelkezés	provisions
szóbeli	oral
házat	house
logikai	Logic
világa	World
fórumhoz	forum
tanfolyamot	training course
üveg	glass
járok	I go
beszélünk	we are talking about
érteni	read
előbbi	former
előfordulhat	may
amelyeknek	which
képezik	are
befektetési	Investment
református	reformed
KDE	KDE
róluk	them
ókori	ancient
hat	six
érvek	arguments
elemzése	Analyze
jelenet	scene
vízben	water
szülő	parent
használati	User
adminisztrátorral	administrator
választható	optional
oszt	divide
literes	l
látok	I see
szebb	beautiful
RTL	RTL
rugalmas	flexible
megszűnt	discontinued
fórum	forum
útját	the way
színvonalú	quality
vmi	sg
szolgálati	service
melyik	which
jármű	vehicle
készülékek	Devices
csillagok	stars
megteheted	you can do
gyereket	children
napjainkban	nowadays
kategória	category
értékeket	values
lábát	leg
híján	almost
megoldása	Solving
szeretek	love
kiadta	released
formák	shapes
szervezők	organizers
nyilvánosság	public
emelkedik	rise
meghaladó	more than
egyelőre	for the time being
császár	emperor
Pécs	Pécs
alkotás	creation
szerveren	a server
akkoriban	then
azzal	with
amelyekben	where
pici	wee
illegális	illegal
változatos	varied
kar	arm
hozzászólásokat	posts
derült	clear
NATO	NATO
kovács	blacksmith
félelem	fear
csatlakozó	jack
megállapodást	Agreement
technológiák	Technologies
közhasznú	non-profit
fejlesztő	developer
PHP	PHP
megelőzően	before
tudná	Could you
okokból	reasons
minősége	The quality
viccet	joke
hívta	called
helyezi	places
előfordul	occur
egyszemélyes	one-man
tőke	capital
merre	whereabouts
világában	World
egész	whole
elolvasni	read
érettségi	graduation
érdekli	about
város	city
egyszeri	single
irányító	governing
tartozott	included
társaságok	Companies
iskolába	school
magamnak	myself
büszke	proud
ismerete	Knowledge
igen	yes
ajtót	door
tantárgy	subject
felmerülő	emerging
értékelő	evaluating
légy	fly
vírus	virus
települési	settlement
erejét	power
optimális	optimum
figyelembevételével	taking into account
istent	god
hosszú	long
figyelni	watch
életbe	life
sorrendben	order
törvényi	laws
pontjában	of
élek	I live in
hivatkozva	Referring to
közreműködésével	co-operation
azonosító	identification
hónapig	months
foglal	deal
jöttem	I came
kézi	hand
réteg	layer
vitát	debate
megéri	worth it
hétig	weeks
bennünk	us
tanácsot	advice
érzik	feel
gyermeke	children
főiskola	college
amiből	which
költség	cost
képzett	qualified
ezeken	these
tapasztalható	observed
mindenben	everything
sebességgel	speed
doktori	doctoral
pár	par
fórumba	forum
melyre	which
nyújtanak	provide
vezetni	lead
forrása	source
veszem	I
tulajdona	property
küldése	Send
választja	choose
múzeum	museum
ennyi	so much
próbál	trying
hagyomány	tradition
tudós	scientist
fok	degree
ezüst	silver
másikra	next
fej	head
szövetségi	federal
írva	written
ellenfél	opponent
kárt	damage
javítani	Improve
regisztrálva	registered
kérdésekben	issues
módját	the way
aláírás	signature
elemi	elementary
módszerrel	Method
engedélyezett	licensed
sok	lot
munkatársa	colleague
fogalmazott	said
elhunyt	deceased
eredményét	The results of
feldolgozása	Processing
amelyből	which
emelt	raised
találkozott	met
határ	border
megfogalmazott	formulated
szőke	blonde
állítható	adjustable
rendszerrel	system
darabot	play
napvilágot	light
nőt	woman
kegyetlen	cruel
lény	being
levelező	correspondent
biztonságot	security
válaszok	Answers
sport	sports
származású	ancestry
köre	The scope
ismerjük	We know
ismerős	familiar
arab	Arabic
tudatos	conscious
irányú	-way
helyben	locally
valószínűleg	probably
filmje	movies
számolt	reported
baloldali	left-wing
mindannyian	all
érti	understand
általam	I have
teljesítése	fulfillment
kapcsolata	relationship
érezni	feel
aztán	then
találkozunk	See you
elnök	chairman
most	now
vásárolni	buy
megrendezett	held
asztali	table
élők	living
tesszük	we do
teljes	complete
csatlakozott	joined
akár	will
kedvem	I feel like
hallgatni	listen
televízió	television
kislány	little girl
férfit	man
vásárolt	bought
tábor	camp
lásd	see
egyetemen	University
csomagok	Packages
utoljára	the last time
hiszi	You think
tehetséges	talented
tavasszal	in the spring
legkésőbb	at the latest
alakja	shape
adjon	add
témákhoz	themes
fesztivál	festival
csupa	full of
listát	Close
autók	Cars
törvényes	legal
modul	Module
kérdésem	My question
melléklet	annex
szerelmi	amorous
lehetőséggel	option
euró	euro
szokatlan	unusual
sokak	many people
kiválóan	great
még	yet
amerikai	American
szabály	rule
menjen	go
legismertebb	best known
döntések	decisions
lakott	inhabited
konferencián	Conference
ipar	industry
döntése	decision
pedagógusok	educators
segített	help
eredő	resultant
belépni	access
tartok	I
engedi	let
láthatjuk	see
maguknak	themselves
gergely	gergely
érdemi	merits
felirat	subtitle
elmegy	go away
szoktak	usually
látvány	sight
soha	never
lista	list
világosan	clear
elégedett	satisfied
aligha	scarcely
magadat	yourself
otthont	home
többség	majority
ellenzéki	opposition
mostantól	It is now
kerek	wheel
szív	heart
ottani	there
kollektív	collective
máskor	another time
költségeit	costs
korszak	era
hatékonyan	effectively
doboz	box
középfokú	secondary
ajánlatot	bid
lépj	please
kimaradt	missed
használták	used
háttér	background
nevezzük	called
kísérlet	experiment
gondol	think
életünk	life
támogatását	support
feltétel	condition
bővült	expanded
legalább	at least
méghozzá	even
barát	friend
címzett	addressee
megegyezik	agree
tiszteletben	Respect
törölni	cancel
tervezi	plan
amennyit	they
bekövetkezett	occurred
mutatnak	exhibit
aludni	sleep
emberekkel	with people
iratkozz	subscribe
rendezvények	Events
véleményük	views
iskolát	school
nemigen	no Yes
bocs	sorry
másrészt	on the other hand
jogos	legitimate
nyafogók	whine
egyetemes	universal
színek	Colours
lemezt	sheet
papír	paper
megtalálni	find
meghatározza	determines
nyarán	In the summer
látogatók	Visitors
jelentőségű	Importance
ténylegesen	de facto
házak	Houses
hivatásos	professional
kórház	hospital
szolgáltatási	Services
mögötte	behind
színpadon	stage
hétköznapi	weekday
jelentek	published
kutató	researcher
működni	work
garanciával	warranty
ajánlat	bid
érni	access
ház	house
miközben	while
olimpiai	Olympic
jelentkezők	candidates
gyerekeket	children
esetenként	occasionally
vad	wild
etikai	ethical
párhuzamos	parallel
netán	maybe
hová	where
támadó	assailant
leggyakrabban	most often
meghatározni	determined
egyetlen	single
index	index
fokozott	intensified
páros	Doubles
beszélek	I'm talking about
látszólag	apparently
együttműködési	cooperation
fordítás	translation
nemsokára	soon
alkalmasak	suitable
egyrészt	on the one hand
tulajdonát	property
hivatott	intended to
macska	cat
Pentium	Pentium
fejlődését	development
szeretni	love
történetében	history
vizsgálatot	investigation
másnak	other
teljesítményű	performance
szintén	also
rendőrök	police
egységek	units
ekkora	such
bejegyzett	registered
cím	title
csoportot	groups
csinált	done
egyeztetés	reconciliation
érkeztek	arrived
szolgált	served
elmaradt	loss
szabályai	Rules
helyek	Places
folyóirat	magazine
kelljen	having
mielőtt	before
tevékenységének	activities
vágott	cut
korabeli	period
adok	I
külön	separately
külön	separately
fizet	pay
tudnám	I could
roppant	highly
ugyan	though
regény	novel
tört	broken
lánya	daughter
belépés	entry
weboldal	website
gyermeket	children
liberális	liberal
középső	middle
fordítani	paid
tipikus	typical
fájdalom	pain
lakik	live
kedve	mood
aratott	victory
apa	father
szerény	modest
látogatói	Visitors
lehetőségei	Possibilities
személyiség	personality
alapját	foundation
szünet	pause
álom	dream
alelnöke	Vice President
őszintén	honestly
elegáns	elegant
voltál	You were
régebben	formerly
Zsuzsa	Zsuzsa
arca	face
éltek	living
rendszerét	system
fal	wall
szándékosan	deliberately
ELTE	ELTE
végleg	permanently
tudatosan	consciously
vala	somehow
szerette	loved
szeretném	I would like to
határozatot	decision
itt	here
vehet	buy
negyven	forty
születik	born
Iván	Iván
növény	plant
szolgálatot	service
segítik	help
tért	returned
szomszéd	next
beruházások	Investments
építészeti	architectural
zsidók	Jews
intelligens	intelligent
gyilkos	killer
fegyveres	armed
csak	only
kérlek	please
írsz	write
problémája	a problem
eléri	reach
idejét	time
mennyiségben	quantity
magamat	myself
Magyarországra	Hungary
támad	attack
jártak	They were
oktató	instructor
moderátor	Moderator
szükségünk	we need
kereskedelem	trade
közösségek	communities
polgári	civil
eltérés	difference
ezentúl	henceforth
tengeri	maritime
sziget	island
ahova	where
főleg	especially
mindketten	both
függvényében	Depending
jelet	mark
Németország	Germany
biblia	Bible
szabályait	The rules
minta	sample
válaszol	answer
munkaügyi	labor
egyetértek	I agree
lassan	slowly
idegenforgalmi	Tourism
művészek	artists
roma	Romany
megoldásokat	solutions
lemezen	disk
békés	peaceful
megengedett	Allowed
csoportja	groups
tudósok	scientists
felvett	recorded
etnikai	ethnic
beszélgetni	talk
nélkülözhetetlen	essential
fogalom	concept
kábel	cable
színe	color
meghirdetett	published
útja	trip
MIÉP	MIÉP
szívvel	heart
áru	goods
folyton	always
matematikai	mathematical
hold	moon
erőszak	violence
írások	Writings
mindig	always
hozzáférhető	accessible
együttesen	jointly
újra	again
jele	sign
USB	USB
tessék	Pardon
emeleti	upstairs
adjuk	add
megakadályozza	prevents
kezdték	started
folyamatot	process
házasság	marriage
pedagógus	educator
játékban	game
győztes	winner
általános	general
állított	delivered
futott	heated
pillanatra	moment
teheti	do
genetikai	genetic
ahol	where
módszert	approach
fejlesztések	Developments
tavaly	last year
legnépszerűbb	most popular
őket	them
időpont	time
méltatlan	unworthy
utasításokat	instructions
sose	Never
adtam	I have
szórakoztató	entertaining
fényes	bright
reális	real
csata	battle
keresik	looking
szakértő	expert
viszony	relationship
elmondani	tell
mentes	free
előttem	me
labdát	ball
munkáltató	employer
mágikus	magical
publikus	published
bevált	Best
pécsi	Pécs
kereszténység	Christianity
fogyasztók	customers
vehetnek	allowed
bajom	my problem
csináltam	I did
viseli	bears
szerződésben	agreement
adható	be
teremtett	created
megtenni	do
Rákóczi	Rákóczi
esély	chance
teljesíteni	meet
utas	passenger
kezdete	beginning
mutatkozik	There is
küzdelem	struggle
kialakítani	develop
ügyek	affairs
néni	aunt
sátánizmus	Satanism
mennyisége	The amount
intézet	institute
jönni	come
csakhogy	only
bérleti	lease
ponton	pontoon
másokkal	others
szállítási	delivery
nemrégiben	recently
megérkezett	arrived
tudjon	learn
ismer	know
étterem	restaurant
náluk	they
körbe	round
előírások	regulations
televízió	television
ellenség	enemy
elvégezni	perform
elmélet	theory
feszültség	tension
kezdetét	beginning
ajándék	gift
senki	no one
szerencsétlen	unfortunate
eme	these
változnak	changing
már	already
nyertes	winner
hatálya	scope
máig	today
életerő	vitality
keret	frame
bejelentés	notification
díjak	charges
kettőt	two
közönséget	audience
tehető	be held
írjon	write
gyakorolt	on
nyolcvanas	Eighties
filmeket	Movies
Márton	Martin
munkában	work
előtérbe	to the fore
belőlük	them
ellenőrizd	check
személyében	in the person of
korrekt	correct
vizuális	visual
Veszprém	Veszprém
azaz	namely
szerezte	scored
szörnyű	terrible
végzik	performed
értékelése	Evaluation
percre	minutes
termelési	production
ugye	right
baja	wrong
fejében	in return
objektív	objective
érdekelne	I would be interested
kaphat	receive
jobboldali	right-sided
tanácsadó	consultant
végét	end
ugyanezt	the same
kreatív	Creative
gyártott	manufactured
szolgáltatók	service
innen	hence
esztétikai	aesthetic
vezeték	wire
rendszerbe	system
egyesek	some
parlament	parliament
városi	urban
munkára	work
különbségek	Differences
emberrel	man
találjuk	find
figyelmen	take into account
kamera	camera
rendezik	settle
nevezték	called
menü	menu
rendelt	assigned
idejében	time
finn	Finnish
komplett	complete
legközelebbi	next
szélén	selenium
igazságot	truth
egyforma	uniform
mindenekelőtt	first of all
kis	little
keményen	hard
tervet	plan
valamiért	for some reason
akadt	caught
eltérően	differently
ugyanez	The same
élet	life
izraeli	Israeli
próbálják	trying
információs	Information
sziasztok	Hi
gondosan	carefully
hallott	heard
gyakrabban	more often
fórumok	Boards
akinek	whose
ellenőrzése	Check
tisztelettel	reverence
levegőt	air
történtek	occurred
azokban	in
filozófiai	philosophical
egyből	immediately
gyerekeknek	Children
eseményeket	events
részeként	As part of
maradék	the rest
közzétett	published
küld	send
helyezkedik	located
tölt	spend
több	more
amatőr	amateur
remény	hope
országos	national
tegyük	place
alkalmazzák	apply
alig	barely
percet	moments
bizottsági	Commission
célokra	purposes
erdő	forest
végi	end
számolni	count
enyhén	mildly
akartak	They wanted
telefonszámon	phone
polgárok	Citizens
üzemi	utility
magányos	lonely
személyt	person
gyakorlatok	Practices
környező	surrounding
intézkedéseket	measures
megjegyzést	remark
fekete	black
képviseli	represented
tagjait	The members
honlapunk	website
helyről	location
színésznő	actress
támogatni	support
művelődési	cultural
belülről	from the inside
kiépítése	building
minthogy	than
hatodik	sixth
adódik	due
lét	life
gondolt	thought
filozófia	philosophy
sűrű	dense
kampány	campaign
munkavállalók	employee
kérelmet	application
hozzád	to you
telken	property
lelke	soul
tölteni	load
győzelem	victory
tetszőleges	optional
oldalain	sides
felvenni	pick
keresem	I'm looking for
boldogság	happiness
vállalkozói	business
tulajdonában	ownership
amelyekkel	which
amellett	besides
szíve	heart
nyelvtani	grammatical
jelentik	are
önt	you
vizsgálati	test
hulladék	waste
kívánják	wish
infrastruktúra	infrastructure
gimnázium	high school
kérelem	application
nagymértékben	largely
válhat	become
gondok	worries
nálunk	book
mértékét	degree
ajánlom	I recommend
találat	hit
mozi	movie theater
módosítani	to change
háborús	wartime
passzív	passive
tisztelt	respected
fogadni	receive
vezetnek	lead
engedélye	permission
elérése	achieve
változásokat	changes
benneteket	you
erőteljes	powerful
veszek	I
léteznek	exist
nézd	watch
növekedett	grown
üzenetek	Posts
legutolsó	latest
adódó	due
ügyet	case
térben	space
problémákkal	issues
ügyfelek	Customers
szokták	often
sátánista	Satanist
nevére	the name
képzésben	training
így	so
jutó	capita
államok	States
működés	operation
területre	area
látunk	We see
zseniális	genius
legyek	flies
formáját	shape
analóg	Analog
keresés	search
beszámoló	report
tizenkét	twelve
generációs	generation
veszély	danger
részre	sections
videó	video
teljesítménye	Performance
soros	serial
egyenként	one by one
ügyfél	client
vizsgálja	explore
sértő	insulting
történetet	story
nagyban	greatly
hatékonyabb	effective
magán	private
örökké	forever
legyünk	be
védelmet	protection
némileg	slightly
szemében	eyes
helyettes	deputy
háromszor	three times
időpontban	time
munkájának	work
számítanak	count
lapon	sheet
eredeti	original
tisztességes	fair
hiány	shortage
településen	town
társadalomban	society
németek	Germans
teremt	create
vállalkozók	Contractors
fegyelmi	disciplinary
mondván	saying,
parti	coastal
vállalta	undertook
csökkenteni	reduced
létszám	staff
hasonló	similar
dolgozom	I work
embere	man
egészségügyi	sanitary
vártam	I expected
értettem	I understood
faluban	village
miatti	due
ünnepélyes	solemn
kaland	adventure
jogait	rights
kormány	government
megállapítani	established
vonatkoznak	apply
kívánnak	wish
rendszerének	system
eszköze	tool
megbeszéléseket	discussions
ezeknek	these
miért	why
asztal	table
generálódott	generated
vállalni	to undertake
mutatni	show
benyújtani	submitted
adót	taxes
megteheti	do
támogatta	supported
jelenthet	pose
feljebb	up
téma	topic
korlátlan	unlimited
javítás	repair
megtalálhatók	found
elit	elite
milliós	million
falusi	rural
informatika	it
gombot	button
kedvezményes	preferential
tények	Facts
nézők	Viewers
példányban	copies
sors	fate
tegyen	do
követve	Following
festett	painted
tudatában	awareness
vonzó	attractive
attól	from
időtartama	The duration
lányt	girl
keresnek	looking
kategóriába	category
akarták	They wanted
ennél	more
szándékkal	Determined
irány	direction
megkapta	received
tanárral	teacher
ízben	time
koncepció	concept
teremteni	Contact
cserébe	in exchange for
tehetsz	do
alkalmat	occasion
korábban	earlier
stílusban	style
sebeztél	wounded
kifejezésére	express
fejezte	finished
hagy	let
önök	you
állapotú	Fresh
formát	shape
szeretnék	I would like to
kívülről	from the outside
tanácsadó	consultant
német	German
állampolgárok	Citizens
eszközt	tool
legalábbis	at least
szociális	social
számítani	expected
londoni	London
telek	site
változatlan	unchanged
fizika	physics
rovatunkban	Our columnist
projektek	Projects
másokat	others
fogadott	adopted
fehér	white
szubjektív	subjective
tedd	put
kapcsolatosan	in connection with
tudtunk	We could
horvát	Croatian
irodai	clerical
októberében	October
láthatóan	visibly
automata	automatic
használatos	Used
felépítése	Structure
általad	by you
szintet	level
amennyire	as far as
menet	march
kapu	gate
tán	perhaps
játszódik	takes
amelyhez	which
változatát	version
jobb	right
családban	family
nos	well
törekszik	seeks
szükségük	need
elemeket	items
karavánnak	caravan
anyaga	material
tartalmáért	contents
szabályzat	Regulations
négy	four
kapok	I get
titokzatos	mysterious
turisztikai	Tourism
hálózaton	network
különbözik	differ
dönteni	decide
televíziós	television
egyedül	alone
helyzetű	status
írják	write
csinálja	doing
uram	mister
visszatér	returns
szavakkal	the words
ellenőrző	inspection
egyházak	Churches
barokk	Baroque
időkben	times
elnevezésű	called
barátságos	friendly
alatta	under
kötni	tie
résztvevői	participants
világbajnok	World Champion
alkotások	Creations
bekezdésének	of
énekes	singer
díja	awards
szerzője	author
sora	line
láttuk	we have seen
kétféle	There are two
növelése	Increasing
forrás	source
csoportban	groups
hallgat	listen
adj	adj
egyszerű	simple
képesség	ability
hangon	voice
küldte	sent
fennálló	existing
hónapokban	months
sikere	The success
nőnek	grow
magáról	himself
jelzett	indicated
forgó	rotary
szeptember	September
fiatalember	young man
próbáljuk	try
felhasználónak	User
bölcs	wise
elkészítése	Preparation
vissza	back
szervezésében	Organised
állt	stood
válaszokat	answers
hozzák	bring
előnyben	preference
hír	news
emelte	raised
szenved	suffer
emailt	emails
megoldható	solvable
fejlesztését	development
hívták	called
karácsonyi	Christmas
használó	user
előrehaladást	progress
gyermekei	children
színpadra	the stage
világra	world
könyvtári	library
potenciális	potential
hiba	failure
kívánunk	We wish
tudat	consciousness
enyhe	slight
busz	bus
svájci	Swiss
álljon	push
valaki	someone
herceg	prince
tudnék	I could
zajló	ongoing
elképzelni	imagine
ítélet	verdict
moderátor	Moderator
időjárás	weather
alap	basis
sokkal	much
élén	at the head
sajnálom	sorry
szentlélek	Holy Spirit
tízezer	ten thousand
képzést	training
fejlesztésére	development
augusztus	August
félre	aside
inkább	rather
hangos	loud
elnökség	presidency
atya	father
terhes	pregnant
idézi	recalls
szelíd	tame
megérteni	to understand
biztosítják	provide
listán	list
zárja	close
nézi	watch
vizsgát	Exam
közbeszerzési	procurement
divat	fashion
mellesleg	by the way
gazdálkodó	business
elemei	Elements
másik	other
születtek	born
ismeretében	Knowing
mondok	I say
lakást	apartment
kilencvenes	nineteen
bajnokság	championship
részei	Parts
környezetvédelmi	Environment
bírja	stand
fogyasztás	consumption
tábla	board
igazolja	confirms
munkájában	work
hétfő	Monday
rosszat	wrong
eldönteni	decide
központja	The center
megszületett	born
hozzászólás	Posts
ellátó	provider
matematika	mathematics
idáig	so far
dolognak	thing
tükrözi	reflects
privát	Private
következőket	following
folytatása	Continue
elkezdett	begun
utóbb	later
kedvelt	favorite
beruházási	investment
világi	secular
élményt	experience
fogad	bet
ismerek	I know
rendezvényen	event
edzés	training
csillag	star
érdeke	interests
adminisztrátor	administrator
csökkentése	Reduction
eredménnyel	results
szerencse	fortune
korántsem	by no means
igyekezett	tried
Eötvös	Eötvös
igazat	truth
idézett	quoted
összegét	The amount
világhírű	world-famous
órában	hours
elveszett	lost
adatvédelmi	Data Protection
értékesítési	Sales
láthatók	shown
London	London
előkészítő	preparatory
regisztrálnod	sign up
órára	hours
jegyet	tickets
gondolják	thought
képező	forming
hát	back
hármas	triple
jelentést	reports
előforduló	occurring
elv	Principle
elvégzése	completion
tanító	teacher
nevén	known
kerti	garden
előttünk	ahead
hátul	Tires
használatának	use
nagyon	very
média	media
vki	sy
este	evening
érzed	feel
kénytelenek	forced
időközben	meanwhile
felhasznált	used
ellenzék	opposition
kutyák	dogs
képessége	ability
rendez	organize
megjelenését	appearance
lakói	residents
lakások	homes
kert	garden
emiatt	therefore,
gondolkodni	thinking
tanítás	teaching
szövege	The text
nyer	win
névnapok	name days
gyengébb	weaker
eleinte	initially
alkalmazását	application
órával	hours
tanulási	Learning
lenyűgöző	amazing
hatások	Effects
biztosítva	ensuring
színpadi	theatrical
integráció	integration
óvatosan	cautiously
közvélemény	public opinion
járunk	We are
tematikus	thematic
legtöbbet	most
lehetünk	We can
egyetemi	university
évtized	decade
céget	firm
felhasználónk	users
anno	anno
intézményben	institutions
meglepetés	surprise
jeles	outstanding
tudjátok	you know
darabig	while
figyelem	attention
milliárd	billion
költségeket	costs
gyár	factory
gondolsz	thinking
hangok	Tones
leírás	description
felvétele	Recording
hat	six
terheli	charged
ellátása	supply
nézem	watch
kidolgozása	Developing
áldozat	sacrifice
csatlakozni	join
mennyiség	quantity
kár	damage
perccel	minutes
puha	soft
interaktív	interactive
szerződések	Treaties
kevéssé	little
táj	landscape
adtál	You have given
fegyver	weapon
jelszó	password
talaj	soil
közoktatási	Public Education
mindaddig	as long
útjára	launched
letölteni	Download
alapokon	Funds
magatartás	conduct
könyveket	ebooks
hacsak	unless
elnézést	excuse me
kereső	finder
kérdéses	in question
ellenben	however,
hosszan	hold
Dezső	Dezso
hatalmi	power
beszéltem	I talked to
színvonalas	high quality
kiadások	expenditures
elérhetővé	available
sorok	Lines
erejéig	up to
zavaró	annoying
barátok	Friends
elkerülése	avoid
fórumba	forum
stúdió	studio
középiskolai	High School
enged	let
baba	baby
arcát	face
csinos	pretty
véres	bloody
nyomás	pressure
írták	written
elteltével	After
bővebben	more
páratlan	unmatched
rejlik	lies
megállapítása	findings
indítani	launch
pénzügyi	financial
szegedi	Szeged
kereslet	demand
jövedelem	income
rendelkezett	ordered
órák	Watches
környezetet	environment
nevezni	called
kedvezmény	discount
érő	force
helyszíni	on-site
formai	Formal
különben	or else
bizonyos	some
érezzük	feel
funkciót	feature
szezon	season
csendben	silently
banki	bank
kéz	hand
túl	too
szent	saint
készíti	prepares
bővebben	more
növelni	increase
nyomokat	clues
szíves	kind
pályázatokat	Applications
dolgoztak	worked
váltott	changed
követelményeknek	requirements
merült	occurred
nehéz	difficult
harcos	warrior
mindent	everything
kifejlesztett	Developed
pap	priest
összességében	overall
paradicsom	tomato
vidéken	countryside
építése	Building
vallja	says
lába	legs
tej	milk
közalapítvány	foundation
súlyosan	heavily
népesség	population
mondanak	they say
megszerzett	acquired
dobozt	box
megállapította	found
intézett	sent
olvasók	Readers
évekig	years
őket	them
újságíró	journalist
viszonyítva	relative
tánc	dance
mondjam	speak
kutyát	dog
szervez	organize
használta	used
bátor	brave
részleteket	details
közli	communicate
környezetvédelem	environmental Protection
párizsi	Parisian
mindenképp	by all means
olvasd	Read
azáltal	by
rendőri	police
válasz	answer
hinni	believe
fővárosban	capital
titeket	you
szóltak	said
mindazt	everything
játéka	play
jellege	Nature
feladatait	duties
rendet	order
rom	ruin
többé	more
kevésbé	less
funkciók	Features
szerkezeti	structural
napról	day
félek	I'm afraid
másnap	the next day
háttérben	background
győri	Győr
sztem	sztem
állás	job
tervezési	design
írom	I am writing
szemem	eyes
évtizedek	decades
szerkezete	Structure
előtt	before
kezelhető	manageable
vacsora	dinner
jelen	present
megjelentek	published
tudást	knowledge
díját	Award
vas	iron
hegyek	mountains
hetet	week
élőben	live
célból	end
túlzott	excessive
elbeszélgetéseket	interviews
bemutatja	presents
egészségi	health
közösség	community
kávéra	Coffee
drámai	dramatic
közúti	road
romák	Roma
másoknak	others
örökre	forever
lépjen	contact
belépési	entry
egész	whole
indít	launch
csapatnak	team
keresse	contact
oldalát	page
művet	work
versenyzők	Contestants
szabó	tailor
hangját	voice
legutóbb	recently
részek	sections
nagyszabású	monumental
tizenöt	fifteen
lehetsz	you can be
oldal	page
mozgó	moving
előbb	before
utóbb	later
hogy	that
tervei	plans
többit	others
mentünk	We went
alak	form
élve	alive
nevezi	calls
kialakítását	creation
okot	reason
minősített	qualified
király	king
szerb	Serbian
gróf	earl
Bartók	Bartók
fényt	light
következô	next
kórházi	hospital
tanszék	Department
hogyan	how
kapcsolatokat	contacts
felnőttek	adults
nevelési	educational
emeli	increase
őrült	crazy
utasítás	instructions
megszerzése	acquisition
rengeteg	a lot of
célokat	goals
vágy	desire
előnyös	advantageous
javasolja	Recommends
távolság	distance
kifejezést	phrase
kezdődő	starting with
képzelni	imagine
boldog	happy
csoportos	group
ünnep	holiday
mindegyike	each
azután	after
kört	round
mindkettő	both of them
ügyekben	matters
várta	expecting
igyekeznek	seek
pénzért	Money
százalékot	percent
kormányt	Government
magasan	highly
másra	anything else
végeztek	conducted
Lukács	Luke
kérésére	At the request of
szépség	beauty
szívem	my heart
keletkezik	created
levegőben	in the air
tiltott	forbidden
felelte	said
életpont	Life points
lejárt	expired
épületben	building
bemutatta	unveiled
műsort	program
mezőgazdaság	agriculture
vizsgálni	tested
sztár	star
forrásból	resources
regionális	regional
garancia	warranty
asztalra	table
mutatták	shown
okozó	causative
érted	for you
színben	colors
objektum	object
különösebb	special
összegű	sum
mutatkozott	There was
megbízott	trustee
visz	carry
illetve	and
történetének	history
kanadai	Canadian
ered	originate
halálra	to death
hatalmat	power
rendelkezések	provisions
nyelvek	Languages
teára	tea
titok	secret
hal	fish
váratlan	unexpected
ősz	autumn
konkrétan	specifically,
adatlapjai	Sheets
dolgoztam	I worked
jelentősebb	major
stílusú	style
legelső	first
lépnek	enter
őszén	In autumn
viták	debates
mármint	I mean
mélyebb	deeper
nyerni	to win
értékelés	assessment
evangélikus	Lutheran
aznap	the same day
cégünk	Our company
küzd	struggle
partnerek	Partners
hónapon	month
nyers	raw
évében	Year
szektor	sector
belépve	Active
deák	scribe
elvek	principles
részleges	partial
munkavállaló	employee
meddig	how long
megteremtése	Creating
állapítja	finds
szia	Hello
vízbe	water
szabályozza	regulated
helyszín	location
autó	car
maximálisan	maximally
vak	blind
melegek	gays
okozza	causes
mehet	go
egér	mouse
verzióját	version
közlemények	releases
hajtott	driven
már	already
hívni	to call
tonna	ton
megmarad	remain
sokszor	often
vicces	funny
forintra	HUF
teszünk	we do
eredményeképpen	result
mik	what
módszertani	Methodological
klinikai	clinical
kezdenek	begin
tovább	further
sebzést	damage
adódóan	Given
forintért	HUF
erősítő	amplifier
reméljük	hope
számla	bill
elemzés	analysis
birodalom	realm
családja	family
esztendő	year
jellemzői	Features
számmal	number
kiállításon	exhibitions
sokat	lot
hozzájárul	contribute
végképp	utterly
számol	count
fórumon	forum
világbajnoki	World Championship
Vilmos	William
pláne	especially
nemzetiségi	Minorities
milyen	what
újdonság	novelty
kerületben	District
köztársasági	republican
használhatók	can be used
munkahelyi	workplace
együttműködést	cooperation
programját	program
javaslom	I recommend
sátán	Satan
cucc	gear
szállás	accommodation
muszáj	must
indulnak	leave
nagyrészt	largely
oldaláról	side
amíg	until
tartalmú	content
tapasztalattal	experience
folytat	continue
fejlődési	developmental
humán	Human
állapot	status
növekedést	growth
változatban	versions
ismerni	recognize
győzelmet	victory
hanghordozó	sound recording
moderálási	Moderation
hála	gratitude
technológiát	technology
könyvben	book
épületet	building
templomot	church
mérési	measurement
versenyek	competitions
pszichológiai	psychological
megjelennek	appear
hoznak	bring
szándék	intent
legsikeresebb	successful
szeptemberben	in September
hold	moon
hangulatot	mood
gyártás	production
bárhol	anywhere
ellenkező	contrary
bort	wine
alkatrészek	parts
kupa	cup
általánosan	generally
Amerika	America
kínálja	offers
olaj	oil
állomás	station
emlékeztet	remind
ökológiai	ecological
területére	area
árán	expense
fakadó	deriving
kártyát	cards
csend	silence
hetedik	seventh
íme	lo
lovas	horse
pécsi	Pécs
eltekintve	aside from
szervezetet	organizations
száll	fly
szeptemberében	September
jóvá	approval
válság	crisis
teste	bodies
feliratkozhat	sign up
méterre	meters
beállítva	set
ellátására	supply
úrnak	Mr.
kisebbségek	Minorities
határt	limit
kliens	client
előzetesen	previously
tervezése	Design
egyetemek	universities
beérkezett	received
fotók	Photos
tájékoztatás	information
költsége	costs
templomban	Temple
megállapítható	concluded
pilóta	pilot
pontokat	items
ötletet	idea
körét	scope
téri	Outdoor
turizmus	Tourism
fajok	Species
segítenek	help
tanít	teach
fér	access
szintje	level
intézkedés	measure
engedélyezte	authorized
érett	mature
rendezte	director
étel	food
neved	Your name
alkalmi	casual
semmiképpen	no way
láthatatlan	invisible
jelentkezési	Application
grafikai	graphic
finoman	gently
elnökének	the President
hitel	loan
tudtok	you can
titokban	in secret
szavazott	Voted
hétvégi	weekend
későn	late
érintettek	stakeholders
jelentkezését	Application of
egyetemen	University
jogokkal	rights
fejlesztői	Developer
táján	Around
örömet	pleasure
bevétel	income
szükségesnek	necessary
párt	party
csatában	battle
rólam	about me
képviselő	representative
testület	body
megtekinthető	view
leírni	describe
kérdeztem	I asked
amennyi	As much
megjeleníteni	Display
államtitkára	Secretary of State
miért	why
hirdet	advertise
gyártása	Production
egri	Eger
itteni	here
hatvanas	sexagesimal
alkotja	make up
mindennek	everything
kialakítására	develop
kipróbálni	to try
mondod	say
számokat	numbers
kérdezi	asks
elhelyezni	post
kedvezőbb	better
irányítja	managed
hibákat	errors
igazgatóság	directorate
tekintik	considered
felhívás	call
kifelé	out
gyere	come on
állati	animal
járművek	vehicles
szorongás	anxiety
kompatibilis	Compatible
jóvoltából	Courtesy
hozzászólásokért	Comments for
hegy	mountain
egészségügy	Health
kollégiumi	collegiate
keresztények	Christians
szabályozott	regulated
mindezt	all
ismételten	repeatedly
védi	protect
kielégítő	satisfying
esetre	event
piszkos	dirty
ciklus	cycle
lapos	flat
világnak	world
módosítás	amendment
állatokat	Animals
igényeinek	needs
iszlám	Islam
hajnalban	dawn
hanem	but also
többségében	most
köszönet	thank
társasági	corporate
aranyos	cute
világba	world
jöjjön	come
tünetek	symptoms
próba	test
kedd	Tuesday
megint	again
jelenetek	Scenes
óriás	giant
int	int
feladatai	Responsibilities
támadástól	attack
ura	lord
Ildikó	Ildikó
büntetés	penalty
eredményez	leads
gyógyszer	medicine
fájdalmas	painful
fürdőszoba	bathroom
váratlanul	unexpectedly
háza	home
testet	bodies
szerelt	fitted
hozzáférési	Access
váló	divorce
telik	take
amitől	makes
negyed	quarter
rendszeren	system
hetvenes	Seventies
végrehajtani	performed
elkészített	made
agy	brain
hossza	Length
alkotják	make up
régióban	region
látnak	see
micsoda	what
írnak	write
hírközlési	Communications
írók	writers
láb	foot
állapotát	status
mióta	since
eggyel	one
vonja	withdraw
sör	beer
remekül	great
elvi	theoretical
ezt	this
listára	list
bolygó	planet
világ	world
küldéséhez	To send a
megvolt	I had
többek	others
oktatásban	Education
jelentőségét	significance
vármegye	County
budai	Buda
gondoljuk	believe
pályát	pitch
legrosszabb	worst
Dénes	Denes
örülök	I am glad
státusz	status
zárva	closed
főre	per capita
ismertette	explained
vesztesz	lose
gyógyszerek	drugs
szerda	Wednesday
nagysága	Size
tapasztalatai	Experiences
telepített	Installed
felhasználás	utilization
árat	reap
vet	cast
rendre	respectively
listáját	list
jelenléte	The presence
idejű	Time
tevékenységi	Activity
részvételével	participation
ponttal	point
nyilvántartásba	register
frissítés	updates
fizetendő	paid
feltételekkel	terms and conditions
ellenséges	hostile
célba	finish line
kórházba	hospital
interjú	interview
hardver	hardware
súlya	weight
talán	maybe
végrehajtása	implementation
mitől	what
sajtótájékoztatón	press conference
ezért	therefore
jegyző	notary
fejlődött	developed
többségi	Majority
forradalmi	revolutionary
kritika	criticism
nyugdíjas	retired
okai	Causes
erőszakos	violent
valójában	in fact
hír	news
doktor	doctor
teológiai	theological
eljárási	procedural
döntöttek	decided
döntöttem	I decided
gond	worry
ahelyett	instead
költői	poetic
érkeznek	arrive
minőségben	Agents
gyakoriság	frequency
elindul	start off
nyújtotta	offered
juhász	shepherd
erősíti	strengthens
támogatással	Support
konferencia	conference
morális	Moral
alul	bottom
társaságában	company
finanszírozási	funding
fennáll	there
zsűri	jury
játszottak	play
amelyről	which
valóságban	in reality
irányítása	guidance
létezett	existed
napokon	days
tesztet	test
művelődési	cultural
tanultam	I learned
korú	ages
fejjel	heads
fogalmát	The concept
eladni	to sell
állok	I stand
moderátorok	Moderators
változatlanul	invariably
tragikus	tragic
tényleg	really
elve	The principle
magyarázat	explanation
könyvtárak	libraries
azelőtt	before
bejelentése	Notification
anyagát	material
csakúgy	just because
jelleggel	character
csomagot	package
érzett	felt
szemlélet	approach
próbálta	trying
írtam	I wrote
professzionális	Professional
lusta	lazy
mese	tale
szeretet	love
katolikus	Catholic
látsz	see
követik	follow
tiszteletére	in respect of
vagyoni	property
egységet	units
szerkesztő	editor
pohár	glass
természetvédelmi	conservation
szóvivője	Spokesperson
feltételeinek	conditions
nekünk	us
képernyőn	screen
elfogadása	Adoption
kórházban	hospital
mellesleg	by the way
fogalmak	Concepts
ezelőtti	ago
csatlakozik	join
válni	become
módszerekkel	methods
állampolgár	citizen
nyíltan	openly
konferenciát	conference
multimédiás	multimedia
egyformán	evenly
fejezetben	section
midőn	when
kiadni	issue
papok	Priests
oldalas	page
előadásokat	performances
lehetőleg	if possible
ügyes	clever
annyiban	so far
merül	dive
délutáni	afternoon
használatára	use
tagság	membership
találnak	s
szállítás	shipping
vízi	aquatic
közismert	known
hozzászólásban	post
szombati	Saturday
kérdés	issue
lét	life
javaslatokat	proposals
szabályozási	Regulatory
mondd	tell
tükör	mirror
ablakban	window
kiemelten	priority
közelben	close
veszélyt	threat
vezetékes	wire
madár	bird
fedett	covered
viselő	bearing
statisztika	statistics
különböző	different
gyógyító	healing
lágy	soft
hívő	caller
igényeit	demands
motorral	engines
rajongók	fans
környéken	area
vehetik	make use of
tudomást	ignored
tartalommal	content
szorul	in need
kormányfő	Government
kapják	receive
létrehozását	creation
világát	world
ismeretes	known
műfaj	genre
nemzet	nation
regisztráció	Sign Up
szellemében	spirit
kint	outdoors
remélhetőleg	hopefully
fokú	degree
ártatlan	innocent
szervezése	The organization
segítségét	for help
fejleszteni	develop
friss	fresh
közölni	communicated
szerinted	think
drágább	expensive
környék	surroundings
emelni	raise
önmaga	himself
tárolt	stored
holnap	tomorrow
jogszabályban	law
táblázatban	Table
kérdései	Issues
jelenségek	events
kívánatos	desirable
gyakorlatot	practice
ellenfeled	opponents
fájlt	file
fenntartjuk	We reserve the
szakos	specializing
hazafelé	homeward
Miskolc	Miskolc
mágneses	magnetic
bejött	came
férj	husband
előadó	performer
sorozatban	series
vásárlás	buying
hatásos	effective
szolgálnak	serving
igényeket	demands
ellátást	supply
növényi	vegetable
nézte	watching
utcára	street
indiai	Indian
hihetetlenül	incredible
ellátni	perform
dokumentumokat	documents
bevonásával	involvement
tavaszán	In spring
tavasz	spring
modellt	model
nyilván	record
fesztivál	festival
sorsát	fate
támadt	attack
kérdezni	ask
témájú	theme
fej	head
megjelenni	released
érnek	worth
Angliában	England
szakon	Faculty
kialakulása	formation
hallható	audible
neved	Your name
szolgálni	serve
lakásban	home
nyilatkozat	statement
fogyasztó	consumer
városa	city
linket	link
sorba	in series
elnöki	presidential
bizonyítani	to prove
vonat	train
korábbi	former
szülői	parental
vidék	country
fejlődik	evolve
kedvezőtlen	unfavorable
időszámítás	Time
beszéltünk	talking
szervezete	organizations
kezdetén	At the beginning
tárgyakat	items
hirdetések	Ads
eszik	eat
találod	find
telefont	phone
motoros	biker
feltehetően	probably
fiai	sons
Margit	Margit
üzemelteti	operates
keletkező	resulting
apám	My father
városba	city
aki	who
hónapra	month
miniszterelnöki	the Prime Minister
kiírt	written
biztosítanak	provide
esélyt	chance
tartósan	permanently
ezenkívül	Besides that
nemzetközi	international
mellékelt	supplied
hiányzó	missing
alaplap	Motherboard
épp	right
fejlődésének	development
elküldött	sent
ausztrál	Australian
felvételt	shooting
fogyatékos	handicapped
függő	dependent
munkába	to work
közlemények	releases
tárgyalt	discussed
bizottsága	The Committee
sorozatot	series
mások	others
alapjait	foundations
annyira	so much
követett	followed by
értik	understand
szer	times
gyakorlati	practical
Népszabadság	Népszabadság
regisztrációs	registration
fenntartása	Maintaining
ajánlatok	Deals
évfolyam	year
tanul	learn
kínált	offered
fejléc	letterhead
megmondani	to say
megerősítette	confirmed
autóval	by car
számodra	for you
szükségesek	required
mész	lime
tulajdonosok	Owners
vasárnapi	Sunday
áruk	goods
adag	dose
tanulmányait	education
versek	Verses
novemberben	in November
vizes	wet
testület	body
méret	size
feltéve	provided
oldani	resolved
fegyverek	Weapons
dalok	songs
fórum	forum
püspöki	episcopal
kódot	code
színt	level
felelt	answer
szándéka	intent
radikális	radical
tanév	school year
rangot	rank
csoport	group
megismerni	learn
adatokkal	data
területeket	areas
döntését	decision
gondoskodni	take care
beszélgettünk	We talked
kívánjuk	wish
mérleg	balance sheet
elkövetkező	next
riport	reportage
időszakában	time
kérünk	We ask
szál	thread
menedzsment	Management
nyugat	West
rejlő	potential
cikkben	Article
előkészítése	Preparation
olvasom	Read
témaváltás	change theme
magyarázatot	explanation
gyártási	manufacturing
kari	Staff
érdekek	Interests
indultak	started
rendezi	settle
nyilatkozatot	statement
nézd	watch
neked	thee
utólagos	follow-up
rendszerű	System
erdei	woodland
csökkenése	decrease
helyezte	placed
hatott	could
megkezdődött	started
Máté	Matthew
üzemeltető	operators
mars	Mars
köti	tie
varázslat	magic
összefoglaló	Summary
irányul	directed
fogadták	accepted
alszik	sleep
állították	They claimed
támogatják	support
konzervatív	conservative
ítélte	sentenced
ügyvéd	lawyer
népe	people
kezdeményezés	initiative
kiterjedő	extending
beavatkozás	intervention
elvégzett	carried out
tanszék	Department
térségben	area
megoldására	to solve
helyezni	move
csere	exchange
rendszereket	systems
legkevésbé	least
japán	Japan
rangú	ranking
önként	willingly
kiállítást	exhibitions
ezekből	these
lényegét	essence
koncertet	concert
bűnös	guilty
nagyságú	size
eljárásban	proceedings
veletek	with you
márka	brand
szállt	staying
hagyom	leave
segítsen	help me
közre	contributed
bevezető	introductory
kenyér	bread
tennie	do
készüléket	equipment
megkapja	receive
szó	word
kényelmesen	comfortably
céljára	purpose
fotó	Photo
szervező	organizer
bibliai	biblical
nulla	zero
várok	I expect
tudományegyetem	science university
tőled	from you
értékelés	assessment
rájöttem	I realized
kimondottan	specifically
említettem	I mentioned
harcot	fight
bankok	Banks
elérhetők	available
túlmenően	In addition to
alapok	foundations
felügyelő	supervisor
bizony	certainly
célzó	for
ének	singing
kamara	chamber
tétele	Making
keveredik	mingle
hírű	famous
hozzájárulás	contribution
megvannak	has its
hírlap	newspaper
semmire	nothing
fejem	My head
szükségem	I need
szava	the words
tárgyat	items
alakultak	developed
szórakozást	entertainment
mondanom	to say
relatív	relative
művei	Works
elsőre	first
tulajdonképpen	actually
szimpatikus	likeable
életmód	way of life
költözött	moved
mag	core
levele	Letter
jogosultak	entitled
felhasználási	applications
Ilona	Ilona
madarak	birds
lakó	residential
béta	beta
hétre	week
kétségtelenül	undoubtedly
étrend	diet
néhányan	Some
szabadságot	freedom
órákban	hours
védelmét	protection
bővebb	more
szabadalmi	patent
emberre	man
kezelt	managed
gyülekezet	congregation
urat	Mr.
topikot	thread in
próbált	tried
esztergomi	Esztergom
misztikus	mystic
jelentkezni	sign in
tartottam	I kept
meteorológiai	meteorological
követelményeket	requirements
célját	purpose
hatáskörébe	competence
csütörtök	Thursday
csinálnak	doing
mindenkor	always
tetejére	Top
nevezhető	It is called
elmenni	leave
körébe	within
laza	loose
Franciaország	France
széleskörű	extensive
jelöli	assigned
bevételek	revenue
technikák	Techniques
megtudni	learn
józan	sober
köszönjük	Thank you
alfa	alpha
barlang	cave
futni	run
kormánynak	Government
példája	Example
amelyekre	which
használatra	use
Pesten	Budapest
helyezték	placed
bővítése	expansion
kedvence	favorite
rendeletben	Regulation
menti	Saves
játékkal	games
számoltak	reported
küldje	Send
miniszteri	ministerial
hitelt	loan
elveszett	lost
tájékoztatta	informed
gólt	goals
darabja	pieces
jövőt	future
aktívan	active
lezajlott	completed
feltétlen	unconditional
képi	kepi
szenvedő	suffering
eltér	differ
nedves	wet
megjegyzés	comment
kazetta	cassette
megismerése	Getting to know
együttműködve	collaboration
szavai	the words
verziót	version
ötleteket	ideas
betöltött	loaded
moderátorok	Moderators
munkához	work
teremben	Hall
kapták	received
hiányzott	missed
eleje	early
kísérletek	Experiments
dob	launch
közéleti	public figures
jelentős	significant
foglalkozás	occupation
útnak	sail
kórház	hospital
információkkal	information
képernyő	screen
szemet	eyes
alábbiak	follows
alapjai	Foundations
vörös	red
győzött	won
találkozni	meet
kérdését	issue
ablak	window
kelet	east
európai	European
november	November
tapasztaltam	I experienced
hiszek	I believe in
hibája	failure
ellenőrzési	inspection
mondhatjuk	say
feleslegesen	needlessly
félévben	semester
autós	motorist
magyarázza	explains
ablakon	window
vágyik	looking
előnyt	benefit
királya	King
utalt	hated
szülei	parents
javasolta	recommended
hozhat	You can
határozzák	determined
barátai	Friends
ütemben	pace
fogott	caught
szülői	parental
védjegy	trademark
vitt	brought
fogadják	accept
számítógépet	computer
vegyen	buy
fejlesztett	advanced
urak	Messrs
holnapi	tomorrow
dizájnváltás	Design changes
munkaerő	labor
Tóth	Toth
fellépő	acting
leány	girl
filmes	movie
néznek	they look
hívott	called
ismételt	repeated
szolgálják	serving
debreceni	Debrecen
ördög	devil
honlapunkon	website
adom	it
spontán	spontaneous
megkérdezte	he asked
képét	image
akikkel	whom they
afrikai	African
fát	tree
megmutatja	shows
második	second
egybe	together
feleségem	My wife
medence	pool
edző	coach
ért	understand
elmarad	fail
alakítja	Converts
köszönöm	Thanks
téves	false
időszakra	the period
tél	winter
másutt	elsewhere
nukleáris	nuclear
kivételes	exceptional
problémái	Problems
pontosan	exactly
elejétől	From the beginning
pályázók	Applicants
közgazdasági	economic
továbbra	continue
dátum	date
értelmezése	Interpretation
vedd	Buy
emlegetett	cited
szolgálat	service
integrációs	integration
fenntartható	sustainable
tartása	Keeping
biztosította	provided
hozzájárult	contributed
szex	sex
gyűjtemény	collection
tudja	you know
frissül	updated
vettük	we
kurzus	course
keretein	framework
dalt	song
érdeklődőket	interested
tanára	professor
helytelen	incorrect
közlekedési	Transport
választják	elected
jogszabályi	legislative
kenyeret	bread
lemezek	Plates
noha	although
félnek	party
lent	down
elismerést	appreciation
könyvében	book
fentebb	above
tapasztalati	empirical
egyedüli	only
Franciaországban	In France
értelmetlen	pointless
adminisztrátort	administrator
érvényesül	prevail
újságírók	journalists
rövidesen	shortly
küldj	send
hátán	backs
elfogadják	accept
melyből	which
belépéshez	enter
tudjanak	be able to
tapasztalatokat	experience
adva	giving
láttak	seen
ipari	industrial
igazolni	verified
soproni	Sopron
franciák	French
szakszervezeti	trade-union
kellően	enough
társai	Others
testvérek	brothers and sisters
jaj	ouch
kör	disease
fűződő	relations
ama	ama
mondatot	sentence
megvalósítására	implementation
istenek	Gods
infláció	inflation
váró	waiting
iratok	papers
csoportokat	groups
ilyesmit	like this
képességek	Capabilities
ismerték	known
versenyben	competition
benned	you
vezethet	lead
dolgozunk	working
vártak	expected
mobiltelefon	cellular phone
egészség	health
háttérbe	background
egyensúly	balance
gyűjteménye	collection
lóerős	horsepower
fizetés	salary
szövegeket	texts
kiterjed	cover
eseményt	event
kereszt	cross
kiegyensúlyozott	balanced
találom	I find
megtartott	held
honnan	from
kapcsolataink	relations
záró	closing
hangulatú	atmosphere
érik	ripen
csaj	chick
telefonos	phone
lejjebb	down
vitték	They were taken
méretben	size
üzembe	Commissioning
hitte	thought
ismertetése	Description
mindvégig	all the time
használom	I use
labda	ball
dokumentáció	documentation
készítő	maker
tüzet	fire
meghívott	invitee
olyannyira	insomuch
módot	mode
nevezetesen	namely,
szféra	sphere
nyugat	West
európai	European
épít	build
tényt	facts
kerültem	I got
közönséges	common
ruha	clothes
ötlete	The idea
számomra	me
egészben	in full
szavait	the words
módszereket	methods
álláspontja	Findings
kínálnak	offered
akármilyen	whatever
évszámok	Model Year
életüket	lives
rovat	column
meghal	die
márpedig	However,
értelem	intellect
kezelő	operator
fentiek	above
megváltozik	changes
nemhogy	not that
legtöbben	Most
említette	said
olcsón	cheap
üzem	plant
hangulatos	cozy
kértem	I asked
irányt	direction
termelő	productive
amerikaiak	Americans
tanulói	student
elképzelés	notion
címeket	titles
testvér	brother
letöltés	Download
hagyják	leave
internetes	online
kezelési	treatment
hajnali	auroral
alapelveinket	our principles
szélsőséges	extremist
részesült	received
fogta	caught
ugyanez	The same
életük	lives
zárta	close
átvett	received
rendelkezései	provisions
pillanatnyilag	momentarily
ismertem	I knew
szóval	so
szerverek	servers
nagyra	highly
miben	wherein
vágya	or the
versenyre	competition
biztosítunk	We offer
nehézségek	Difficulties
olyanokat	with a
zavarja	bother
extrák	extras
utazó	traveler
fogni	catch
divatos	fashionable
forgalomban	available
reggel	morning
időpontját	stay
tulajdonságai	Properties
nézték	Views
nyomtató	printer
addigra	by then
élénk	lively
jelentettek	reported
tantárgyak	Subjects
kék	blue
területét	area
kiadásában	edition
Ausztria	Austria
közigazgatás	government
életemben	my life
terjedt	spread
változása	Changes in
hónapok	Months
fürdő	bath
tehetnek	they can do
pillanatok	moments
cserélni	replaced
mágia	magic
szelleme	The spirit
hivatali	administrative
munkanélküliség	unemployment
megindult	moved
hozzáférést	access
hotel	hotel
fejezi	expresses
veszélye	Danger
hangosan	loud
kilométer	kilometer
elől	Tires
háborút	battles
különleges	special
hordozható	portable
ajánlunk	We offer
kötelezettséget	liability
számviteli	Accounting
veti	throws
bejön	come in
ágazat	sector
példány	copy
éli	lives
oktatást	Education
egyiket	one of them
komolyan	seriously
minőségét	The quality
gyakorló	practicing
nyolcadik	eighth
mező	field
egyáltalán	at all
körülötte	around
valósul	realized
feltehetőleg	presumably
készek	to date
agresszív	aggressive
szegény	poor
mentális	Mental
érsek	archbishop
túlnyomó	overwhelming
jelölte	identified
lelkek	spirits
negyedévben	quarter
megpróbálja	tries
képre	picture
hivatkozott	cited
hatalma	power
ezekhez	these
szerte	around
népet	people
főt	people
korosztály	ages
vevők	Buyers
ellenőrizni	check
alkot	create
jövök	I come
szabályos	regular
eljött	come
tárgyalás	negotiation
két	two
három	three
szűkebb	narrower
következményei	Consequences
nagyok	great
kiadványok	Periodicals
esetet	case
boldogan	happily
értékelés	assessment
azokon	on
minap	the other day
jövője	Future
dologban	thing
ajánlatkérő	contracting
felhasználónév	user name
papi	priestly
dologra	things
hűvös	cool
úgysem	anyway
ukrán	Ukrainian
levelében	letter
kereste	Searched
megítélése	perception
témával	theme
állott	stale
váltó	changer
megalakult	formation
színészek	Actors
hányszor	How many times
fájlok	Files
műsorok	Shows
torony	tower
találkoztunk	We met
adatlap	sheet
elénk	us
polgármesteri	mayor
gazdálkodás	management
államilag	state
emlékek	Memories
legegyszerűbb	Easiest
alkalmaz	apply
nevelő	educator
párbeszéd	dialogue
munkavégzés	Working
énekesnő	singer
magunknak	ourselves
ellenőrzi	check
tanévben	school year
tervezik	plan
növekedési	Growth
munkahely	workplace
rendbe	right
kisebbség	minority
évtizedes	decades
feltüntetett	indicated
túra	tour
opció	option
élére	edge
elkezdtem	I started
rajtunk	us
készítettek	created
animációs	Animation
sűrűn	densely
látva	seeing
rendelkezésünkre	available
okát	reason
kiváncsi	curious
vezérigazgatója	Chief Executive Officer
beszélget	talk
felkészülés	preparation
utaló	suggestive
kölcsön	loan
kísérletet	experiment
válogatás	Selection
gyanús	suspicious
ezúttal	this time
felügyelet	supervision
többszöri	multiple
halált	death
unió	union
iskolákban	schools
amibe	whatever
csakhogy	only
anyám	my mother
terve	plan
szóljon	speak
oldalakat	sites
jobbat	better
pénteki	Friday
tananyag	curriculum
kollégium	dorm
foci	football
hajú	haired
romániai	Romania
láthatunk	see
pályázaton	Competition
hiszik	believe
edző	coach
hallom	I hear
befektetők	Investors
szakmailag	professionally
mondjak	I say
békés	peaceful
fegyvert	weapons
motor	engine
megszerezni	to acquire
hozzátette	added
családot	family
örömére	delight
szobák	Rooms
nyújtja	offers
összeállított	compiled
fenyegető	threatening
témáról	topic
kiállított	issued
szólj	speak
rendezni	settle
forrásokat	resources
ismerteti	presents
utolsó	last
kötelesek	They are required
zavart	embarrassed
házépítés	house building
menjünk	let's go
kutatói	Researchers
hozzáférés	access
könyvtárban	directory
módosíthatja	change
befejezése	completion
kereskedő	dealer
segítünk	help
készítenek	draw
ruhát	clothes
nyertek	won
nyelve	Language
keretei	framework
juthatnak	get
foglalkoztatási	Employment
szívesen	willingly
léptek	footsteps
egyetért	agree
nézzük	let's
védő	protector
eredményesen	efficiently
egyenlőre	for now
kiszolgáló	Server
értelmét	meaning
maradhat	stay
falak	Walls
kamara	chamber
tapasztalata	experience
meccset	match
megváltoztatni	to change
saját	own
félelmetes	formidable
másodszor	secondly
igényelt	required
jellemezte	characterized
kötelessége	duty
ész	wit
kritikusok	Critics
felmérése	Survey
határoz	decide
fordulnak	turn
megfelelő	appropriate
kurva	bitch
létszáma	The number
vért	armor
nyitni	to open
sajtóban	the press
évezred	millennium
mindhárom	all three
utakon	roads
szerető	valentine
rendőrségi	police
közösséget	community
banda	gang
központjában	center
fontosak	are important
megállt	stopped
másképpen	otherwise
megvalósítását	achievement
aerobik	aerobics
virág	flower
leírások	descriptions
évről	year
esztendőben	year
hallotta	heard
kicsiny	little
nevéhez	the name
küldi	sent
hajrá	go for it
tekintjük	considered
másik	other
veszünk	We are
tájékoztatni	informed
erdélyi	Transylvania
ingatlanok	properties
foglalkozunk	deal
befolyásoló	influential
alkotmány	constitution
amúgy	anyway
helyzetének	status
falat	morsel
dkg	ounces
végeznek	perform
milliárdos	Billionaire
felszínre	surfaced
teljesíti	fulfill
gondos	careful
jobb	right
problémám	a problem
megvalósításához	realization
rendszernek	system
amolyan	sort of
annyi	so much
angol	English
osztályok	classes
istennel	god
állapotot	status
fotókat	Photography
írása	Writing
erdőben	woods
támogatásra	aid
tanítási	school
vásárlók	Customers
maradandó	imperishable
visszatérő	recurring
beszélhetünk	speak
kérdéseit	issues
esedékes	due
feladatát	task
oldalára	website
mérkőzést	match
hiányos	deficient
jelző	marker
vegyük	Remove
más	other
ítélt	sentenced
ágy	brain
szakaszában	phase
értékeli	evaluate
kívánta	sought
szegények	the poor
keskeny	narrow
fodor	frill
tulajdonságok	Properties
érint	touch
menü	menu
kötelezettségek	Liabilities
kiállítása	The exhibition
miket	what
sebessége	speed
webes	Web
legjobbak	best
Horváth	Horvath
nyit	open
anyagból	material
átmérőjű	in diameter
őrzi	preserves
közel	close
találkozón	meeting
megtekintése	View
használhatja	You can use
tanácsadás	guidance
követelmény	requirement
hónapot	month
interjút	interview
lejár	expire
elkezdődött	started
ülést	meetings
jobbak	better
kérdésére	question
zár	lock
teljesítette	fulfilled
fiatalokat	young people
hálózatot	network
dokumentumot	Document
kiindulva	Starting from
olvashatók	read
számlát	bill
részletes	detailed
kihívás	challenge
szuper	super
megkezdett	begun
küldjön	Send
mindenki	everyone
még	yet
egy	one
viccet	joke
török	Turkish
elutasítja	rejects
fontosságát	the importance of
írtál	
sört	
bejelentett	
állítása	
munkatársak	staff
bevezetését	
törekvés	pursuit
lelkét	
gondolatot	
tönkre	damage
érdemel	worth
mással	
polgármestere	
irodák	
zenés	musical
egyesülete	
magukkal	
közösségben	
erőforrások	
alkalmazási	
rendszerint	usually
elnyerte	
javasoljuk	We recommend
tükrében	
autópálya	
mar	bite
funkcionális	
gimnázium	high school
elképesztő	amazing
fokon	
szállító	carrier
fele	half
dönti	
lelkész	minister
váltani	
ebéd	lunch
másodlagos	
intézményekben	
értelmiségi	
elnevezés	
technológiával	
mérhető	
folynak	
hagytam	I left
válaszolta	
terhére	expense
decemberében	
polgár	citizen
polgármesteri	
szerez	gain
határok	limits
hagyományosan	
elmondja	says
azokról	
szenvedés	misery
műtét	operation
gondolata	
fiatal	young
cseréje	
pillanatnyi	
koffer	
Románia	
parti	coastal
tetszenek	Satisfaction
légi	air
igyekszünk	
időzóna	
sajnálom	sorry
nemzetek	
mester	master
elektronikai	electronic
vas	iron
aranyat	
hatalmas	powerful
szórakozás	
készítője	
teljesített	
szeretjük	
nyelv	language
magánszemély	
legyél	Be
függőleges	vertical
karakterek	Characters
minőséget	
igazán	really
reméljük	hope
számítógéppel	PC
határozata	
piacot	
cikkeket	
diplomát	
forgalma	turnover
fordulóban	
ügye	affairs
régiók	
ható	acting
valószínűséggel	
gombbal	
felhívni	
összekötő	Liaison
tömeges	massive
viszik	
főiskola	college
állítás	
homoszexuális	gay
ázsiai	
típusok	
kialakulását	
jelenlétében	
előállított	
kíváncsiak	
felelőssége	
kisebb	less
nagyobb	
vámpirizálsz	
szerdai	
kötelezően	
függvény	function
immáron	
értesítést	
kisfiú	
telepítés	installation
teljesítményét	
udvari	court
támogatásban	
látogatás	
kertben	
garanciát	
javaslatok	
hölgyek	
folyamatokat	
oktatók	
mindezek	
vállalkozási	
kocsit	
részeket	
bizalom	confidence
lesz	will be
keltett	
bíboros	cardinal
nyitotta	
felvételek	
amiatt	because
lerakót	
sportos	Sports
melyekkel	
kialakuló	
újra	again
feldolgozás	
beszélő	speaking
találkozhatunk	meet
célunk	
tesztek	
jutunk	
menő	cool
nélkül	without
hajtja	
alakítani	shape
vélte	
javaslata	
örömmel	gladly
utca	street
generáció	generation
százalékra	
igazoló	
dolguk	
építettek	
dolgozat	dissertation
tartalmaznia	
utazik	travel
őrmező	
rajtad	up to you
osztályú	
kérdésekkel	
észrevételeit	
cége	
pénze	money
döntési	
birodalom	realm
érvényben	
világába	
fiát	
szobor	statue
mátrix	matrix
terhesség	pregnancy
fém	
tagjának	
habár	
ingyen	Free
civilizáció	
lejátszó	player
eladási	selling
hülyeség	nonsense
származnak	
fényében	
figura	figure
mennyivel	how much
megrendelő	customer
hozzászóláshoz	
témától	
mérkőzésen	
kötve	
gyógyítás	Healing
kijelző	display
racionális	rational
hetekben	
adminisztrátorok	
fel	up
szerkeszteni	
háztartási	domestic
tehetik	
hagyományok	
ablakot	windows
védelmére	
efféle	
személynek	
külföldre	abroad
kedvezményt	
kör	disease
gazda	administrator
tulajdonsága	
értékesítés	
külügyminiszter	
ingyenes	free
haladt	
országnak	
tulajdonú	
logikus	
figyelmébe	
érdekelnek	
kezelését	
eljön	
ételek	Foods
égi	
számíthat	
dán	
tus	Indian ink
székhelyű	
egyiptomi	
igazából	actually
grafika	graphics
praktikus	practical
tucat	
római	Roman
arányos	cute
két	two
ötvenes	
eredeti	
verset	poem
lássuk	
mert	because
szabályozó	
szegénység	
piacán	
bízott	
regisztrációt	
tapasztalatait	
szavazatok	
mélyén	
feltételeknek	
mezőgazdasági	
körök	
fokos	
városában	
hajdani	of yore
ugyanígy	
tulajdonosi	
merev	rigid
cikke	
fiút	
beszámolót	
megújult	
vitatkozni	arguing
eszközei	
munkaügyi	
irányított	guided
gyakorlattal	
osztályban	classroom
leggyorsabb	Fastest
válaszoltak	
fenék	buttocks
munkanélküli	unemployed
nőknek	
különálló	separate
társa	companion
bevezetett	
legerősebb	powerful
hasonlóan	
szép	beautiful
ablakok	
hangulata	
kódokat	
alapjául	
készlet	stock
jutottam	
akarat	will
nyelvvizsga	language exam
kiválasztása	
elhanyagolt	
vízszintes	
megadása	
szabványos	
július	
anyagiak	
hozzászóláshoz	
vonalon	
megnövekedett	
struktúra	
udvar	court
regisztrálja	
moderátori	
egy	one
törlése	
életünket	
pont	point
liszt	flour
bármilyen	any
inni	to drink
fura	weird
felületet	
közvetett	indirect
októberben	
kritikai	
akit	
képei	Photos
évtizedben	
beszerezni	obtain
választása	
lehetőségük	
energia	power
lapra	
ezáltal	
fizetnek	pay
művelt	cultivated
elemet	items
lakók	residents
kulcs	key
kifejtette	
cigányok	
országában	
mostmár	now
vélik	
alkohol	
térbeli	
bírói	
ide	here
figyel	listen
gondolkodik	think
oldaladra	
szókincs	vocabulary
kuratórium	
alkotmánybíróság	
szobába	room
hozzájárulásával	
kezdik	
szolgáltatása	
egyidőben	
változatot	
nevével	
idejére	
szakszerű	
alkalmazásának	
kezet	
felügyeleti	surveillance
ragyogó	brilliant
között	between
messzire	
időpontjában	
látom	I see
használva	
felszíni	
Szolnok	Szolnok
kádár	
fogadó	inn
tudnánk	we could
megfigyelhető	
törpe	dwarf
miskolci	
viszonya	
segítette	helped
alacsony	low
sziget	island
indokolja	
fölösleges	
reneszánsz	
államigazgatási	
kerülne	
ezekben	these
beszélik	
végülis	after all
hegyi	mountain
ugyanabban	the same
rendje	
jellegét	
nőket	
vetette	
tanított	taught
évfordulója	
alkotta	
sárkány	dragon
történetek	Stories
megalapozott	
évtizede	
jóllehet	
elvesztette	lost
egészen	
májusban	
elkezd	begins
elsőként	
látogat	visit
szakadt	torn
erotikus	erotic
kíséri	accompanied by
elismerte	
logisztikai	
okán	
bár	bar
forgalmat	
amelyeken	
napirendi	
mennyei	
vonni	
bűncselekmény	crime
titka	The secret
állva	
evangélikus	Lutheran
törvényjavaslat	
alkotnak	
jelszóval	
professzor	
ismertté	
rendelkeznie	
társas	gregarious
takács	
automatikus	
távozott	leaving
felhívja	Draws
tea	
legkülönbözőbb	
felújítása	
érez	feel
teszek	
élen	
elhelyezése	
tagjaként	
fölötti	
akciók	
kapcsolni	switch
befolyásolják	
hirdeti	
folyamata	
székely	
tulajdon	property
szerkesztette	
pápai	
forrást	
fenntartja	
jogviszony	
kever	mix
szívében	heart
döntéseket	choices
igazi	real
megfelelnek	
ábrán	
tágas	
eléréséhez	
haladva	
ajánlati	
választod	
odáig	so far
hangulatát	atmosphere
nyomorult	
használtak	
tekint	look
rögzíteni	
bonyolultabb	
indította	
étkezési	
legizgalmasabb	
kaphatnak	
festő	painter
kialakulásának	
folytatás	sequel
haladja	
jelentkezés	
vélt	
boltban	
lelket	soul
tisztelet	reverence
tévé	camel
elkerülhetetlen	inevitable
cégnek	
érthetetlen	incomprehensible
segítségére	
korona	crown
gumi	gum
tudó	scientists
módosítását	
veszed	
buta	silly
végbe	
hívnak	called
alakulnak	
elnézést	excuse me
felsőoktatás	
indulás	departure
gépeket	
szabadságharc	War of Independence
előadók	
híre	news
kis	little
kivel	
halkan	softly
haladéktalanul	
szokások	
értelemszerűen	
fakad	
túlzottan	
találok	
előadása	Presentation
telepítése	
szakszervezetek	
vén	old
egymillió	
hanggal	with sound
ágyas	
információért	
érzelmek	Emotions
könyvét	
finanszírozott	
értelmezni	
belépő	admission
sem	neither
rendezték	
érdeklődését	
sikertelen	failed
segítőkész	helpful
megnézem	watch
kölcsönösen	
tanítani	to teach
segíthet	
játssza	
ülő	
május	May
kiterjedt	
ezekről	
éhes	hungry
elnökét	
emberben	
mondhatom	I can tell you
korom	soot
névvel	name
mennyiségi	quantitative
középpontjában	
szerinte	according to him
ismertek	
tradicionális	traditional
beszédet	speech
Csongrád	
landol	lands
órája	
találkozót	appointment
rendeznek	held
elősegítése	Promoting
szabad	free
alkalmazza	
csökkenő	
úgymond	
műholdas	
ellenállás	
lelkem	
jelentkeznek	
nyugat	West
veszteség	
letöltése	
kollokvium	Colloquium
amerikai	American
helyenként	places
közép	middle
ágyban	bed
összefüggés	context
asszonyok	
kapjon	
kövér	fat
funkciója	
elavult	obsolete
szigeten	
vezetési	
gyorsan	fast
magáért	
újszerű	
kapcsolva	
békét	peace
szerződéses	
lássuk	
turisták	Tourists
csinálok	
használd	Use
közérdekű	
ismertetett	
előnyei	Benefits
váljon	
vasút	
aláírt	signed
óriási	giant
délre	
szabadtéri	
tartózkodik	staying
karácsony	Christmas
százezer	lakh
megnéztem	
hangsúlyozza	
régi	old
mérés	
középen	
születtem	I was born
konferencia	conference
tűnnek	
tervező	designer
laboratóriumi	
egy	one
tárolása	
ágazati	
hagyták	
követelményeinek	
fórumot	
többre	
töltse	
alakulása	
átvette	
fene	hell
engedéllyel	
kösz	thanks
bolt	store
utóbbit	
találkoznak	meet
megáll	stop
kellenek	
vezetőjének	
vásárló	customer
igyekszem	I try
fejléc	
akarata	
kertész	gardener
eseménye	
mutattak	
megszólal	sounds
jellemzője	feature
bizottságok	
tanácsokat	
országa	
férfi	man
melyhez	
választhat	
igényli	
rögzíti	
találhatóak	
növelte	increased
célunk	
találkozás	
kezelést	
futás	
szövegét	
gyakorlat	practice
jegy	ticket
doktor	doctor
kitűzött	
jelzik	
szélessávú	broadband
kedves	Dear
középkorban	
produkció	
mérnök	engineer
tárgyalásokat	
rendezése	
motort	engine
sajna	unfortunately
szocialisták	
csúcs	apex
urunk	
tíz	ten
módjára	
elmegyek	I go
nyilvánosan	
egyikük	
dolgokról	
átmenetileg	
támadást	attack
egyenletes	even
húzni	Pull
válaszolok	
típusa	Type
ilyeneket	like that
szemle	
méltán	worthily
kellemes	pleasant
veheti	
melyeknek	
csatornák	
főnök	boss
kilométerre	
legenda	
kezdetben	
régészeti	
bárminemű	
megőrzése	
sokoldalú	versatile
adminisztratív	
múltkor	
kapcsolatát	
adatainak	
közepe	the middle
később	later
szauna	
választásokon	
katasztrófa	
jogvédelem	
vendégeket	
tulajdonosai	
országból	
fideszes	
legyőzte	
ifjúság	
eladott	sold
heves	intense
fájlokat	
szolgáltatásait	
néma	dumb
részlet	installment
Benedek	
örömét	
kedvencem	my favorites
alább	below
lények	
elemeit	
szerek	products
példák	Examples
emlékszik	remember
rendszerre	
juthat	
alkalmaznak	
munkások	
láttunk	we saw
márpedig	
partnere	Partner
kérnek	
megkezdése	commencement
értékelni	appreciate
kel	cabbage
egyszersmind	
fordítása	
mára	
rendelkezéseit	
jöhetett	
forduljon	contact
előfordult	
rádiós	
próbáld	
csupán	only
parkoló	
küldjük	sent
valahogy	
ajánlja	
segg	ass
várva	
vonult	
tojást	
következtetésre	conclusion
kérdéssel	
javítását	
támogat	support
jövőbeli	
rendjét	
végrehajtott	
sejtek	
állítólag	supposedly
forintba	
oktatói	
háta	backs
amióta	since
ezeken	these
jelöltek	
benne	in it
szabályozása	
megfelelni	meet
szülés	birth
alkotmány	constitution
örül	be happy
fordulat	turn
várom	look forward
belépett	entered
építették	
feleségét	
találtunk	found
cégnél	
unióhoz	
nevem	
halak	Fish
megvenni	buy
meccsen	
áldozatot	
valamennyien	
hall	hear
neki	him
nagyobb	
feleség	wife
kérik	
övé	
fizikailag	
beállítani	
ugyanilyen	same
nyoma	
jelszavát	
ital	beverage
kiinduló	
formátum	
kapcsolódnak	
hogy	that
szél	wind
végzettség	Education
próbálni	Try It
válás	divorce
precíz	precise
magamban	
folytató	
nyomja	
kézben	
nézek	
hozzájárulása	
küldd	Send
rendelni	assigned
felhívta	called
fejléceit	
jövőbeni	
eszerint	
szállítással	
panel	
olcsóbban	
előtt	before
munkás	working
halálát	
jönne	
nyomban	
sláger	
féléves	
kizárt	
javult	improved
csillogó	shining
mellettem	me
semmivel	nothing
húst	
hollywoodi	
eszközzel	
királynő	
rovatban	
barátság	friendship
végeztem	finished
csinálta	did
válna	
mester	master
kétségbe	
koncerten	
helyzetéről	
biztonságban	safe
színre	
célul	
munkanélküliek	
kiválasztani	choose
szereplői	
rokon	kin
erőforrás	
szimbolikus	
együttese	
manapság	these days
lapban	
éjszakát	Nights
megválasztott	
képvisel	represent
tehetünk	
költségei	
megjelenítésére	
hitet	
környezetbarát	
számítástechnika	Computing
imagekhez	
mindegy	all the same
kerestetik	
fűződik	
kártyák	Cards
elejére	
építkezés	building
összehasonlító	comparative
tartomány	
hűséges	faithful
körökben	
jelentették	
mégegyszer	once more
miből	
tartózkodás	
szakasza	
panaszos	complainant
megteszi	
elméletileg	theory
végezték	
kérték	
hírei	
közalkalmazotti	
nevezünk	
téged	you
tábornok	general
szervezetnek	organizations
ajtón	
várakozás	
országaiban	
jegyek	
szeretete	love
érvényesek	
földön	
igazolt	
témakörben	
tejet	
színpad	
magyarázata	
órákon	
jóváhagyott	
hús	meat
fejedelem	
építő	building
díszes	
válasszon	choose
pontján	
töltöttem	
tervezték	
használunk	
tanácsok	
kiadását	
elmondható	
csinálják	
dolgokra	
tervezet	
szavazatot	
fejére	
kitöltve	
gyakorlata	
minden	all
éljen	Long live
adatbázisban	
szerző	author
részesül	
kastély	mansion
multinacionális	Multinational
Orbán	Orban
maradok	stay
használtam	
érdeklődést	interest
idézet	
édesapja	
szedni	
feltett	
tájékoztatása	
kinek	everyone
védekezés	
munkákat	
viselkedés	behavior
okoznak	
művelet	
lakos	inhabitant
értékelve	
tágabb	
újságot	
felvilágosítást	
felhasználásuk	
magadnak	yourself
gépi	
szerencsém	
kiegészítve	
nálam	I have
mondotta	
leszámítva	
felhasználót	
műveletek	
januárban	in January
hívei	
kívánom	I would like to
utóbbiak	
fejlődést	
ameddig	as long as
rendszertelenül	
kezdeményezésére	
alkotni	
megközelítés	approach
zenész	musician
tessék	Pardon
kollégium	dorm
részből	
fogyasztása	
mindennap	every day
terem	hall
kihasználva	
rajz	drawing
vélem	I
valamire	something
láttam	I saw
közelébe	
küldöm	I will send
norvég	Norwegian
érezhető	
lapunknak	
irodában	
körülmény	circumstance
felügyelete	
kerestem	I was looking for
létét	
valóságot	
elképzelések	
tekintet	
áram	power
Gáspár	
felelni	meet
alkalmazottak	
ugyebár	
magánszemélyek	
leírást	
rendeztek	
legalacsonyabb	
belga	Belgian
legnehezebb	
uhu	
keressük	search
megtörténik	
fájdalmat	
követhető	
végezhető	
irányadó	
állatot	
napját	
valamennyi	all
menüpontra	
korig	
tendencia	
számba	inventory
mérsékelt	
megkezdte	
láttán	
sír	grave
fontosságú	
említi	
bizonyíték	
akadálya	
előny	benefit
angyal	angel
nyugszik	
lehettek	
születése	Birth
postán	
egyének	
hajók	ships
reagál	
falvak	
megtartani	hold
ellátva	
megadja	
általi	
tudományok	
blokk	Block
írni	write
ösztöndíj	
röviden	short
tok	capsule
forog	
nyitja	opens
belátható	
kétszáz	two-hundred
beszéltek	
ítélték	
Krisztina	Krisztina
növekedését	
környezetében	
anyagilag	financially
nálad	
tevő	
kevesebben	
hibátlan	
formátumú	
mészáros	butcher
kövesd	
szólj	speak
elfelejtettem	
istenhez	
részesülnek	
kijön	come out
nyomozás	
direkt	Direct
lépnie	
értelmi	
életnek	
gazdálkodási	Management
vizsgák	Exams
társadalmat	
tekintélyes	stately
becsületes	honest
tegyék	
szerepeltek	
László	Laszlo
rétegek	
szörny	monster
vezettek	
megszüntetése	
szemű	eyed
stúdió	
valósult	
jövőre	next year
ebbe	in this
előzőleg	
címedet	
sötétség	
infó	
alakuló	
váltotta	
kilométeres	
küldjön	
bizonyára	surely
producer	
gépkocsi	
híven	
kezem	I have
java	java
állampolgári	Citizens
kevés	few
helyszíne	
esnek	
vettél	Did you
előterjesztést	
kell	must
bemutatkozó	
városokban	
parton	
otthonában	
magából	
témákban	
szavát	
hátterében	
egyezmény	
ülések	
kapcsolt	connected
sík	
kapcsolható	
gondom	
bőséges	
vereséget	
irányában	towards
sorában	
határideje	
javítására	
elviselni	bear
hirdetési	
folytatódott	
problémával	
szerződés	agreement
értékeit	values
márciusában	
helyiség	
területfejlesztési	
hidd	Believe
tanácsa	council
kémia	chemistry
nekem	me
stílust	
kérdés	issue
édesanyja	
kimagasló	
értékének	
unióban	
vesztette	lost
fogyasztási	
elhanyagolható	
kötetben	
áldozata	
elvitte	took
bejelentést	
államnak	
hosszas	
augusztusban	in August
tojás	egg
nyomtatás	printing
örökös	heir
megbízásából	
befogadó	recipient
brazil	Brazilian
beszélgetést	interview
előtted	in front of
moziban	
garantálja	
sötétben	
időszakot	
programjának	
szerelme	love
vezérlő	
vezetést	
természetben	
bemutatására	
átadott	
sőt	moreover
cégünk	
kiemelte	
partnereink	
tulajdonságait	
képviselt	
mert	because
szabványok	
palesztin	
összegyűjteni	
kiadást	
fizeti	
bővül	expanding
megkérdezni	
készítette	created
évesek	
decemberben	
zárójelben	in parentheses
sikereket	
szorult	
kerüljenek	
védeni	Protect
sérülés	injury
pert	lawsuit
nagyméretű	
november	November
vendége	guest
mechanikai	mechanical
veszett	lost
felhasználásra	
gyümölcs	
elhagyta	leaving
progi	
mérni	
tény	fact
halljuk	
küldés	
kötődik	bound
vizek	
mondanám	say
eltöltött	
szeretem	love
előkelő	noble
úgy	so
zárult	
paraszt	peasant
feladatra	
ülnek	
évenként	
srácok	
januárjában	
tanulásra	
mindegyik	all
készítették	
jusson	
funkcióval	
üzemel	operate
menekült	refugee
nevetséges	ridiculous
kihívást	challenge
munkáltatói	Employer
menüpont	
megjelenítéséhez	
határozta	
osztott	
varázslatos	enchanting
augusztus	August
sorát	
kultúrát	
mindnyájan	
mindazok	
játékokat	
gondolunk	think about it
oroszok	
elnökségi	
veszélyezteti	
évekkel	
felfogás	perception
órai	
kialakításában	
amikor	when
uniós	
lírai	lyric
valamelyest	
teljesség	wholeness
paraméterek	
lőtt	
lámpa	light
rendelhető	
sebességet	
figyelemre	
alighanem	
cselekvés	
szándékát	
fellelhető	
vont	
címén	
véleményem	in my opinion,
jogú	
koromban	
szerinted	think
délután	afternoon
napjaink	
skót	Scottish
híve	
valóra	reality
előírásoknak	
foglalkozások	
kegyelem	grace
bízom	I trust
jótékony	beneficent
fejlesztésének	
büdös	smelly
gyönyörű	beautiful
idő	time
dráma	drama
üzletet	business
éltem	
fordulni	
arcán	
alapította	founded
szervezeteket	
hajlamos	prone to
kiváltó	
védelmében	
megtalálod	
eközben	
nyelvre	
vettünk	
normatív	
dolgozói	
költészet	
lehetőségünk	
művét	
ajánlotta	recommended
jártál	
sérti	
igyekeztek	
születésnapját	
meghaladta	
javítja	
más	other
hajlandóak	
tárgyát	
nemet	currency
elemző	analyst
sziasztok	Hi
menetét	
jókat	Ships
Mózes	Moses
busz	
mobiltelefonok	Mobile phones
gyereknek	
bírom	I can
alkotása	
volta	was the
kapjuk	
jórészt	
megbízást	
igazán	really
foglalta	occupied
végezzük	
patak	creek
kifejezett	
szeretetet	
olvasott	
technikát	
elősegíti	help
vasárnap	Sunday
megpróbál	try
megjegyezni	remember
néhol	
Londonban	London
lezárt	closed
alakított	
logók	Logos
jellemzők	Features
feleségül	
melléklete	
kívánó	
májusában	
haja	
frank	
kísérő	
társadalombiztosítási	
étkezés	meal
utalnak	
orvoshoz	
érzésem	
akkor	then
szerkesztés	
feküdt	lying
szervezetekkel	
munkálatok	
hálás	grateful
meglepően	surprisingly
vonatkozásban	
igényét	
errefelé	
utazott	
őrzött	
nyugalom	tranquility
megadva	
szervezni	
június	June
sebességű	
megoldását	
fertőzött	infected
csatolni	
kereskedők	Dealers
ütközik	conflict
férjem	My husband
duma	spiel
foglaló	reservation
mindössze	
eljutni	reach
mennem	I have to go
apostol	
terveket	
hangulatban	
gyűjtött	
mégse	
egyezmény	
akadnak	
felbontás	
szakemberei	
díjakat	
születési	Birth
angyalok	Angels
vásárlási	
leírását	
halk	quiet
hirtelen	suddenly
épülnek	
ügyesen	ably
pótolni	
dologról	things
ajándékot	Gift
törvényeket	
olvasta	read
riasztó	alarm
küldhetsz	post
ideiglenesen	
versenyeken	
bekövetkező	
csodás	wonderful
tájékoztatja	
hírlevelek	
kori	Ages
ismeretekkel	
hirdetett	
eleinte	
aláírást	
tizenegy	eleven
regisztrálhatja	
amennyiben	inasmuch
multimédia	multimedia
üzenetére	
paranccsal	
félévében	
hátteret	
kétséges	
kezdődően	
csepp	drop
március	March
millió	million
egyesületek	
központok	
gyakorolni	to practice
erejű	
istentől	
posta	
politikát	
újságok	newspapers
hiányoznak	missing
arccal	
micsoda	
eközben	
érzést	
esete	
ügyészség	
üzenete	
ülve	
mondtak	
íme	lo
elkezdte	started
feladatainak	
énekel	sing
hagyd	let
nyújthat	
feléd	
megjelenési	
fordította	
olasz	Italian
Jakab	James
totál	
módra	
egységesen	
jegyzőkönyv	protocol
alkalmazására	
szögletes	square
szolgáltatásokkal	
bizottságának	
jelenteni	
formális	
módban	
fogalmaz	formulates
titkára	
gárda	
hívek	
felkészült	
mindazokat	
jelentések	
exkluzív	exclusive
nemrég	
rendezvényt	
kaliforniai	
eséllyel	
zöld	green
kínálat	supply
konfliktus	
értjük	understand
protestáns	
elemzők	
hasznot	
weboldalon	
katona	soldier
elnökség	
kivételesen	exceptionally
követték	
feltenni	ask
írtad	
biztosítás	insurance
tagját	
lezárása	
látszó	
határozati	
fóruma	
határán	
különböző	different
úrnak	
németországi	
alakban	
engedte	
épülete	
környéke	Surroundings
területein	
rendeletet	
kitalálni	figure out
gondolkodó	
városnak	
kifejezések	Expressions
tizedik	tenth
jogosultságokat	
csalódás	disappointment
zenészek	Musicians
ismerünk	
imént	just
ígért	
megtanulni	
labdarúgó	footballer
keddi	
szövetségének	
elhelyezkedő	
császári	
indítanak	
rendezésében	
viselt	wearing
változtatás	
fennmaradó	
dolgom	
előnyeit	
érzékelhető	
egyéb	other
megpróbálom	
bírta	
dolgunk	
októberi	
azokhoz	
tiszt	officer
előfizető	
nevének	
távolságra	
külföldiek	
panasz	complaint
estére	evening
először	first
állhat	
szezonban	
büszkén	
üresen	
erejével	
megkérdezi	
eredményre	
meredek	
gondolták	
kisváros	
esetlegesen	
csapatban	
előrejelzés	forecast
elkerülni	avoid
művészeti	artistic
elfoglalt	busy
hetek	I
törölheti	
meglátjuk	
legmegfelelőbb	
hatásai	
megadásával	
bizonyosan	assuredly
képpel	
rovására	
értékesítése	
magam	I
önök	you
jócskán	
egyidejű	
mindazonáltal	
menedzser	manager
képez	
illeszkedik	
keretet	
megtartása	
közép	middle
európai	
teljes	complete
munkái	works
mindazon	all
rohadt	damn
végrehajtási	
hangsúlyozni	
kombinált	
jelezni	reported
tulajdonos	
létesítmény	facility
magyarázni	explain
fórumra	
képességét	
dolgát	
beszerzési	
értesíti	
emlékeztető	reminder
